chrom	start	end	strand	total_mapped_reads	unique_mapped_reads	shared_reads	feature	class	annotation_group
chr1	629571	629622	+	33	0	33	MT-TM(Mt_tRNA),URS000004104A_9606(tRNA),URS000004CD95_9606(tRNA),URS000006D24F_9606(tRNA),URS000006E464_9606(tRNA),URS00000CDC85_9606(tRNA),URS000012560A_9606(tRNA),URS00001514AC_9606(tRNA),URS000016E495_9606(tRNA),URS00001771F0_9606(tRNA),URS0000198468_9606(tRNA),URS00002116D6_9606(tRNA),URS000022D70F_9606(tRNA),URS000028B0CA_9606(tRNA),URS000029471C_9606(tRNA),URS00002C70E1_9606(tRNA),URS00002D6C4C_9606(tRNA),URS00002E11B0_9606(tRNA),URS000032DA45_9606(tRNA),URS00003BAAEC_9606(tRNA),URS00003BD079_9606(tRNA),URS00003BD296_9606(tRNA),URS000040608E_9606(tRNA),URS00004768E7_9606(tRNA),URS00004A64D0_9606(tRNA),URS00004F3A6C_9606(tRNA),URS000058ABCE_9606(tRNA),URS00005AA786_9606(tRNA),URS00006045B9_9606(tRNA),URS000060EDEE_9606(tRNA),URS0000734079_9606(tRNA),URS00007627D9_9606(tRNA),URS0000767F97_9606(tRNA),URS000076EE6F_9606(tRNA),URS000077A336_9606(tRNA),URS00007816CE_9606(tRNA),URS0000785BDB_9606(tRNA),URS000078EA85_9606(tRNA),URS00007AFD01_9606(tRNA),URS00009B1A3D_9606(lncRNA),URS00009BCEB9_9606(lncRNA),URS00009C24C1_9606(lncRNA),URS00009C52E9_9606(lncRNA),URS00009FC39C_9606(tRNA),URS00009FCF3B_9606(tRNA),URS00009FDB49_9606(tRNA),URS0000A00F79_9606(tRNA),URS0000A16893_9606(tRNA),URS0000A19F47_9606(tRNA),URS0000A38EFA_9606(tRNA),URS0000A44C08_9606(tRNA),URS0000B81AA6_9606(tRNA),URS0000D77905_9606(tRNA),URS0000DBC2F8_9606(tRNA),URS0000DC1407_9606(tRNA),URS0000DC36BE_9606(tRNA),URS0000DC5E62_9606(tRNA),URS0000DCA1D2_9606(tRNA),URS0000DCB48E_9606(tRNA),URS0000DCB9BF_9606(tRNA),URS0000DCBB5E_9606(tRNA),URS0000DCF513_9606(tRNA),URS0000DD1716_9606(tRNA),URS0000DD371E_9606(tRNA),URS0000DD379C_9606(tRNA),URS0000DD4F76_9606(tRNA),URS0000DD8D9B_9606(tRNA),URS0000DE0DC0_9606(tRNA),URS0000DE44D1_9606(tRNA),URS0000DEAF1C_9606(tRNA),URS0000DED4EC_9606(tRNA),URS0000DED9FE_9606(tRNA),URS0000DEF114_9606(tRNA),URS0000DEF561_9606(tRNA),URS0000DF1732_9606(tRNA),URS0000E49904_9606(tRNA),URS00019A2F7A_9606(tRNA),URS00019A4364_9606(tRNA),URS00019D7114_9606(tRNA),URS0001DA32A6_9606(tRNA),URS0001DC1F46_9606(tRNA),URS000219A035_9606(tRNA)	A	SM-ONLY
chrMT	4401	4452	+	33	0	33	MT-TM(Mt_tRNA),URS000004104A_9606(tRNA),URS000004CD95_9606(tRNA),URS000006D24F_9606(tRNA),URS000006E464_9606(tRNA),URS00000CDC85_9606(tRNA),URS000012560A_9606(tRNA),URS00001514AC_9606(tRNA),URS000016E495_9606(tRNA),URS00001771F0_9606(tRNA),URS0000198468_9606(tRNA),URS00002116D6_9606(tRNA),URS000022D70F_9606(tRNA),URS000028B0CA_9606(tRNA),URS000029471C_9606(tRNA),URS00002C70E1_9606(tRNA),URS00002D6C4C_9606(tRNA),URS00002E11B0_9606(tRNA),URS000032DA45_9606(tRNA),URS00003BAAEC_9606(tRNA),URS00003BD079_9606(tRNA),URS00003BD296_9606(tRNA),URS000040608E_9606(tRNA),URS00004768E7_9606(tRNA),URS00004A64D0_9606(tRNA),URS00004F3A6C_9606(tRNA),URS000058ABCE_9606(tRNA),URS00005AA786_9606(tRNA),URS00006045B9_9606(tRNA),URS000060EDEE_9606(tRNA),URS0000734079_9606(tRNA),URS00007627D9_9606(tRNA),URS0000767F97_9606(tRNA),URS000076EE6F_9606(tRNA),URS000077A336_9606(tRNA),URS00007816CE_9606(tRNA),URS0000785BDB_9606(tRNA),URS000078EA85_9606(tRNA),URS00007AFD01_9606(tRNA),URS00009B1A3D_9606(lncRNA),URS00009BCEB9_9606(lncRNA),URS00009C24C1_9606(lncRNA),URS00009C52E9_9606(lncRNA),URS00009FC39C_9606(tRNA),URS00009FCF3B_9606(tRNA),URS00009FDB49_9606(tRNA),URS0000A00F79_9606(tRNA),URS0000A16893_9606(tRNA),URS0000A19F47_9606(tRNA),URS0000A38EFA_9606(tRNA),URS0000A44C08_9606(tRNA),URS0000B81AA6_9606(tRNA),URS0000D77905_9606(tRNA),URS0000DBC2F8_9606(tRNA),URS0000DC1407_9606(tRNA),URS0000DC36BE_9606(tRNA),URS0000DC5E62_9606(tRNA),URS0000DCA1D2_9606(tRNA),URS0000DCB48E_9606(tRNA),URS0000DCB9BF_9606(tRNA),URS0000DCBB5E_9606(tRNA),URS0000DCF513_9606(tRNA),URS0000DD1716_9606(tRNA),URS0000DD371E_9606(tRNA),URS0000DD379C_9606(tRNA),URS0000DD4F76_9606(tRNA),URS0000DD8D9B_9606(tRNA),URS0000DE0DC0_9606(tRNA),URS0000DE44D1_9606(tRNA),URS0000DEAF1C_9606(tRNA),URS0000DED4EC_9606(tRNA),URS0000DED9FE_9606(tRNA),URS0000DEF114_9606(tRNA),URS0000DEF561_9606(tRNA),URS0000DF1732_9606(tRNA),URS0000E49904_9606(tRNA),URS00019A2F7A_9606(tRNA),URS00019A4364_9606(tRNA),URS00019D7114_9606(tRNA),URS0001DA32A6_9606(tRNA),URS0001DC1F46_9606(tRNA),URS000219A035_9606(tRNA)	A	SM-ONLY
chrX	55180180	55180231	-	27	0	27	URS0001DC1F46_9606(tRNA),URS0000B3E5AB_9606(tRNA),URS000004CD95_9606(tRNA),URS0000734079_9606(tRNA),URS0000DEAF1C_9606(tRNA),URS0000DC5E62_9606(tRNA),URS0000DED4EC_9606(tRNA),URS0000A44C08_9606(tRNA),URS0000DD4F76_9606(tRNA),URS00003BD079_9606(tRNA),URS0000DCB9BF_9606(tRNA),URS00001514AC_9606(tRNA),URS000022D70F_9606(tRNA),URS000060EDEE_9606(tRNA)	L	SM-ONLY
chr17	19603346	19603397	+	13	0	13	URS00003BD079_9606(tRNA),URS0000DED4EC_9606(tRNA),URS0000DE0DC0_9606(tRNA),URS0000A44C08_9606(tRNA),URS0000DD4F76_9606(tRNA),URS0000DC5E62_9606(tRNA),URS0000DEAF1C_9606(tRNA),URS00005AA786_9606(tRNA),URS0000DCB9BF_9606(tRNA),URS000060EDEE_9606(tRNA),URS0001DC1F46_9606(tRNA)	L	SM-ONLY
chr1	629500	629556	+	1277	0	1277	MT-TI(Mt_tRNA),URS00000012EC_9606(tRNA),URS000000DC32_9606(tRNA),URS00000225B7_9606(tRNA),URS000008D191_9606(tRNA),URS00000A2867_9606(tRNA),URS00000A75D2_9606(tRNA),URS00000DFAB7_9606(tRNA),URS00000F6EEF_9606(tRNA),URS00000F70DA_9606(tRNA),URS00001751B9_9606(tRNA),URS000018DD5C_9606(tRNA),URS00001C17EA_9606(tRNA),URS00002375A2_9606(tRNA),URS00002416BA_9606(tRNA),URS000025082B_9606(tRNA),URS0000268D36_9606(tRNA),URS000029799C_9606(tRNA),URS00002DD8DF_9606(tRNA),URS0000301A56_9606(tRNA),URS000035B2D7_9606(tRNA),URS000035D8E2_9606(tRNA),URS0000366CD4_9606(tRNA),URS00003A9CC0_9606(tRNA),URS00003BCE1B_9606(tRNA),URS00003BE447_9606(tRNA),URS00003C4419_9606(tRNA),URS00003DEE1F_9606(tRNA),URS00003EA65E_9606(tRNA),URS00003F05AD_9606(tRNA),URS0000400AFD_9606(tRNA),URS0000455600_9606(tRNA),URS000045DE45_9606(tRNA),URS000047595F_9606(tRNA),URS000048F118_9606(tRNA),URS00004CAA6C_9606(tRNA),URS00004F0373_9606(tRNA),URS000052A3A4_9606(tRNA),URS000058AF3F_9606(tRNA),URS00005B03EF_9606(tRNA),URS00005BC760_9606(tRNA),URS00005D1607_9606(tRNA),URS00005E40B1_9606(tRNA),URS0000602B66_9606(tRNA),URS000060F07A_9606(tRNA),URS000073F530_9606(tRNA),URS000076C388_9606(tRNA),URS000076D7F1_9606(tRNA),URS000076F3F0_9606(tRNA),URS000076FAF1_9606(tRNA),URS0000772095_9606(tRNA),URS0000776367_9606(tRNA),URS000077959F_9606(tRNA),URS0000780DF3_9606(tRNA),URS0000785F64_9606(tRNA),URS00007C40CB_9606(tRNA),URS00007DB19F_9606(tRNA),URS000082F6E4_9606(tRNA),URS000082F8E7_9606(tRNA),URS00009B1A3D_9606(lncRNA),URS00009BCEB9_9606(lncRNA),URS00009C24C1_9606(lncRNA),URS00009C52E9_9606(lncRNA),URS00009E642D_9606(tRNA),URS0000A6A38D_9606(tRNA),URS0000AD97CF_9606(tRNA),URS0000B5BD8D_9606(tRNA),URS0000B8970E_9606(tRNA),URS0000BA48F3_9606(tRNA),URS0000C93A1D_9606(tRNA),URS0000CBCD9D_9606(tRNA),URS0000CBE3E1_9606(tRNA),URS0000DBD6FB_9606(tRNA),URS0000DBE28A_9606(tRNA),URS0000DC56AA_9606(tRNA),URS0000DC62AA_9606(tRNA),URS0000DC8207_9606(tRNA),URS0000DCBD36_9606(tRNA),URS0000DCBECE_9606(tRNA),URS0000DCCD87_9606(tRNA),URS0000DCD0F0_9606(tRNA),URS0000DD21F6_9606(tRNA),URS0000DD3C38_9606(tRNA),URS0000DD4947_9606(tRNA),URS0000DD61BB_9606(tRNA),URS0000DD76A0_9606(tRNA),URS0000DD9917_9606(tRNA),URS0000DDBB99_9606(tRNA),URS0000DE88EC_9606(tRNA),URS0000E0DB98_9606(tRNA),URS0000EC62AA_9606(tRNA),URS0000ED2164_9606(tRNA),URS0001074B50_9606(tRNA),URS00019AB64B_9606(tRNA),URS00019BCB27_9606(tRNA),URS00019C095E_9606(tRNA),URS00019FE6BB_9606(tRNA),URS0001A0044A_9606(tRNA),URS0001BC1FB7_9606(tRNA),URS0001C26227_9606(tRNA),URS0001C3E6CC_9606(tRNA),URS0001CDF064_9606(tRNA),URS0001DF9333_9606(tRNA),URS0002214FF1_9606(tRNA),URS0002269E0F_9606(tRNA)	A	SM-ONLY
chrMT	4330	4386	+	1277	0	1277	MT-TI(Mt_tRNA),URS00000012EC_9606(tRNA),URS000000DC32_9606(tRNA),URS00000225B7_9606(tRNA),URS000008D191_9606(tRNA),URS00000A2867_9606(tRNA),URS00000A75D2_9606(tRNA),URS00000DFAB7_9606(tRNA),URS00000F6EEF_9606(tRNA),URS00000F70DA_9606(tRNA),URS00001751B9_9606(tRNA),URS000018DD5C_9606(tRNA),URS00001C17EA_9606(tRNA),URS00002375A2_9606(tRNA),URS00002416BA_9606(tRNA),URS000025082B_9606(tRNA),URS0000268D36_9606(tRNA),URS000029799C_9606(tRNA),URS00002DD8DF_9606(tRNA),URS0000301A56_9606(tRNA),URS000035B2D7_9606(tRNA),URS000035D8E2_9606(tRNA),URS0000366CD4_9606(tRNA),URS00003A9CC0_9606(tRNA),URS00003BCE1B_9606(tRNA),URS00003BE447_9606(tRNA),URS00003C4419_9606(tRNA),URS00003DEE1F_9606(tRNA),URS00003EA65E_9606(tRNA),URS00003F05AD_9606(tRNA),URS0000400AFD_9606(tRNA),URS0000455600_9606(tRNA),URS000045DE45_9606(tRNA),URS000047595F_9606(tRNA),URS000048F118_9606(tRNA),URS00004CAA6C_9606(tRNA),URS00004F0373_9606(tRNA),URS000052A3A4_9606(tRNA),URS000058AF3F_9606(tRNA),URS00005B03EF_9606(tRNA),URS00005BC760_9606(tRNA),URS00005D1607_9606(tRNA),URS00005E40B1_9606(tRNA),URS0000602B66_9606(tRNA),URS000060F07A_9606(tRNA),URS000073F530_9606(tRNA),URS000076C388_9606(tRNA),URS000076D7F1_9606(tRNA),URS000076F3F0_9606(tRNA),URS000076FAF1_9606(tRNA),URS0000772095_9606(tRNA),URS0000776367_9606(tRNA),URS000077959F_9606(tRNA),URS0000780DF3_9606(tRNA),URS0000785F64_9606(tRNA),URS00007C40CB_9606(tRNA),URS00007DB19F_9606(tRNA),URS000082F6E4_9606(tRNA),URS000082F8E7_9606(tRNA),URS00009B1A3D_9606(lncRNA),URS00009BCEB9_9606(lncRNA),URS00009C24C1_9606(lncRNA),URS00009C52E9_9606(lncRNA),URS00009E642D_9606(tRNA),URS0000A6A38D_9606(tRNA),URS0000AD97CF_9606(tRNA),URS0000B5BD8D_9606(tRNA),URS0000B8970E_9606(tRNA),URS0000BA48F3_9606(tRNA),URS0000C93A1D_9606(tRNA),URS0000CBCD9D_9606(tRNA),URS0000CBE3E1_9606(tRNA),URS0000DBD6FB_9606(tRNA),URS0000DBE28A_9606(tRNA),URS0000DC56AA_9606(tRNA),URS0000DC62AA_9606(tRNA),URS0000DC8207_9606(tRNA),URS0000DCBD36_9606(tRNA),URS0000DCBECE_9606(tRNA),URS0000DCCD87_9606(tRNA),URS0000DCD0F0_9606(tRNA),URS0000DD21F6_9606(tRNA),URS0000DD3C38_9606(tRNA),URS0000DD4947_9606(tRNA),URS0000DD61BB_9606(tRNA),URS0000DD76A0_9606(tRNA),URS0000DD9917_9606(tRNA),URS0000DDBB99_9606(tRNA),URS0000DE88EC_9606(tRNA),URS0000E0DB98_9606(tRNA),URS0000EC62AA_9606(tRNA),URS0000ED2164_9606(tRNA),URS0001074B50_9606(tRNA),URS00019AB64B_9606(tRNA),URS00019BCB27_9606(tRNA),URS00019C095E_9606(tRNA),URS00019FE6BB_9606(tRNA),URS0001A0044A_9606(tRNA),URS0001BC1FB7_9606(tRNA),URS0001C26227_9606(tRNA),URS0001C3E6CC_9606(tRNA),URS0001CDF064_9606(tRNA),URS0001DF9333_9606(tRNA),URS0002214FF1_9606(tRNA),URS0002269E0F_9606(tRNA)	A	SM-ONLY
chr3	129397294	129397348	-	513	8	505	SNORA7B(snoRNA),URS00006F6999_9606(snoRNA),URS00008B27BB_9606(lncRNA),URS00008B7C15_9606(lncRNA),URS00008BD02B_9606(lncRNA),URS00008BD462_9606(lncRNA),URS00008C0989_9606(lncRNA),URS00008C12DC_9606(lncRNA),URS00008C3712_9606(lncRNA),URS00008C3A2B_9606(lncRNA),URS0000D5956D_9606(lncRNA),URS0001BC215F_9606(snoRNA),URS0001BDDDB1_9606(lncRNA),URS0001BE196D_9606(lncRNA),URS0001BF3D65_9606(lncRNA),URS0001BF959A_9606(lncRNA),URS0001E4FB13_9606(lncRNA)	A	SM-ONLY
chr3	12840396	12840450	-	505	0	505	URS00008C1AC2_9606(lncRNA),RPL32(protein_coding),URS0001BC70F1_9606(snoRNA),SNORA7A(snoRNA),URS00003852FE_9606(snoRNA)	L	SM-PC
chr13	44917947	44917998	-	457	0	457	URS00003C9A26_9606(tRNA),URS00019D48EB_9606(lncRNA),URS0001BF93FC_9606(tRNA)	A	SM-ONLY
chr15	26082254	26082305	-	457	0	457	URS00003C9A26_9606(tRNA),URS00019D48EB_9606(lncRNA),URS0001BF93FC_9606(tRNA)	A	SM-ONLY
chr3	12840308	12840363	-	10	0	10	RPL32(protein_coding),SNORA7A(snoRNA),SNORA7B(snoRNA),URS00003852FE_9606(snoRNA),URS00006F6999_9606(snoRNA),URS00008B27BB_9606(lncRNA),URS00008B7C15_9606(lncRNA),URS00008BD02B_9606(lncRNA),URS00008BD462_9606(lncRNA),URS00008C0989_9606(lncRNA),URS00008C12DC_9606(lncRNA),URS00008C1AC2_9606(lncRNA),URS00008C3712_9606(lncRNA),URS00008C3A2B_9606(lncRNA),URS0000D5956D_9606(lncRNA),URS0001BC215F_9606(snoRNA),URS0001BC70F1_9606(snoRNA),URS0001BDDDB1_9606(lncRNA),URS0001BE196D_9606(lncRNA),URS0001BF3D65_9606(lncRNA),URS0001BF959A_9606(lncRNA),URS0001E4FB13_9606(lncRNA)	A	SM-PC
chr3	129397206	129397261	-	10	0	10	RPL32(protein_coding),SNORA7A(snoRNA),SNORA7B(snoRNA),URS00003852FE_9606(snoRNA),URS00006F6999_9606(snoRNA),URS00008B27BB_9606(lncRNA),URS00008B7C15_9606(lncRNA),URS00008BD02B_9606(lncRNA),URS00008BD462_9606(lncRNA),URS00008C0989_9606(lncRNA),URS00008C12DC_9606(lncRNA),URS00008C1AC2_9606(lncRNA),URS00008C3712_9606(lncRNA),URS00008C3A2B_9606(lncRNA),URS0000D5956D_9606(lncRNA),URS0001BC215F_9606(snoRNA),URS0001BC70F1_9606(snoRNA),URS0001BDDDB1_9606(lncRNA),URS0001BE196D_9606(lncRNA),URS0001BF3D65_9606(lncRNA),URS0001BF959A_9606(lncRNA),URS0001E4FB13_9606(lncRNA)	A	SM-PC
chr1	629639	629690	+	6	0	6	MT-ND2(protein_coding),MTND2P28(unprocessed_pseudogene),URS000028B0CA_9606(tRNA),URS00009B0D2B_9606(lncRNA),URS00009B1A3D_9606(lncRNA),URS00009BCEB9_9606(lncRNA),URS00009C0F4C_9606(lncRNA),URS00009C24C1_9606(lncRNA),URS00009C52E9_9606(lncRNA)	A	SM-PC-PS
chrMT	4469	4520	+	6	0	6	MT-ND2(protein_coding),MTND2P28(unprocessed_pseudogene),URS000028B0CA_9606(tRNA),URS00009B0D2B_9606(lncRNA),URS00009B1A3D_9606(lncRNA),URS00009BCEB9_9606(lncRNA),URS00009C0F4C_9606(lncRNA),URS00009C24C1_9606(lncRNA),URS00009C52E9_9606(lncRNA)	A	SM-PC-PS
chr1	630360	630420	-	6	0	6	URS000003B6E2_9606(lncRNA),URS00008BA18E_9606(lncRNA),URS00009BD87E_9606(lncRNA),URS00009C5FD3_9606(lncRNA),URS00009C5FD9_9606(lncRNA),URS0000D5BF25_9606(lncRNA),URS0000D5C109_9606(lncRNA),URS0000E92860_9606(lncRNA),URS0001BCFF7F_9606(lncRNA),URS0001BD8551_9606(lncRNA),URS0001BD991C_9606(lncRNA),URS0001BDDA63_9606(lncRNA),URS0001BDEDEE_9606(lncRNA),URS0001BDEFB5_9606(lncRNA),URS0001BE0009_9606(lncRNA),URS0001BE5970_9606(lncRNA),URS0001BE7101_9606(lncRNA),URS0001BEA1A4_9606(lncRNA),URS0001BEA413_9606(lncRNA),URS0001BEA497_9606(lncRNA),URS0001BECF55_9606(lncRNA),URS0001BEDC58_9606(lncRNA),URS0001BEEFB7_9606(lncRNA),URS0001BF4B92_9606(lncRNA),URS0001BF68FD_9606(lncRNA),URS000220D60B_9606(lncRNA),URS00022128AF_9606(lncRNA),URS0002214815_9606(lncRNA),URS0002228680_9606(lncRNA),URS000222C263_9606(lncRNA),URS000225B45A_9606(lncRNA)	A	NO-SM
chrMT	5190	5250	-	6	0	6	URS000003B6E2_9606(lncRNA),URS00008BA18E_9606(lncRNA),URS00009BD87E_9606(lncRNA),URS00009C5FD3_9606(lncRNA),URS00009C5FD9_9606(lncRNA),URS0000D5BF25_9606(lncRNA),URS0000D5C109_9606(lncRNA),URS0000E92860_9606(lncRNA),URS0001BCFF7F_9606(lncRNA),URS0001BD8551_9606(lncRNA),URS0001BD991C_9606(lncRNA),URS0001BDDA63_9606(lncRNA),URS0001BDEDEE_9606(lncRNA),URS0001BDEFB5_9606(lncRNA),URS0001BE0009_9606(lncRNA),URS0001BE5970_9606(lncRNA),URS0001BE7101_9606(lncRNA),URS0001BEA1A4_9606(lncRNA),URS0001BEA413_9606(lncRNA),URS0001BEA497_9606(lncRNA),URS0001BECF55_9606(lncRNA),URS0001BEDC58_9606(lncRNA),URS0001BEEFB7_9606(lncRNA),URS0001BF4B92_9606(lncRNA),URS0001BF68FD_9606(lncRNA),URS000220D60B_9606(lncRNA),URS00022128AF_9606(lncRNA),URS0002214815_9606(lncRNA),URS0002228680_9606(lncRNA),URS000222C263_9606(lncRNA),URS000225B45A_9606(lncRNA)	A	NO-SM
chr1	630324	630414	+	5	0	5	MT-ND2(protein_coding),MTND2P28(unprocessed_pseudogene),URS00009B0D2B_9606(lncRNA),URS00009B1A3D_9606(lncRNA),URS00009BCEB9_9606(lncRNA),URS00009C0F4C_9606(lncRNA),URS00009C24C1_9606(lncRNA),URS00009C52E9_9606(lncRNA)	A	NO-SM
chrMT	5154	5244	+	5	0	5	MT-ND2(protein_coding),MTND2P28(unprocessed_pseudogene),URS00009B0D2B_9606(lncRNA),URS00009B1A3D_9606(lncRNA),URS00009BCEB9_9606(lncRNA),URS00009C0F4C_9606(lncRNA),URS00009C24C1_9606(lncRNA),URS00009C52E9_9606(lncRNA)	A	NO-SM
chr11	62853895	62853969	-	7816	7816	0	SNHG1(lncRNA),URS0000164B86_9606(snoRNA),URS00005F4016_9606(misc_RNA),URS00008B57DA_9606(lncRNA),URS00008C0C32_9606(lncRNA),URS00008C0CC6_9606(lncRNA),URS00008C1085_9606(lncRNA),URS00008C1464_9606(lncRNA),URS00008C167B_9606(lncRNA),URS00008C1D08_9606(lncRNA),URS00008C2147_9606(lncRNA),URS00008C22A8_9606(lncRNA),URS00008C22F5_9606(lncRNA),URS00008C2432_9606(lncRNA),URS00008C24BC_9606(lncRNA),URS00008C2EDC_9606(lncRNA),URS00008C355C_9606(lncRNA),URS00008C392D_9606(lncRNA),URS00008C3AA7_9606(lncRNA),URS00008C3E49_9606(lncRNA),URS00008C409D_9606(lncRNA),URS00009B63CD_9606(lncRNA),URS00009B9E39_9606(lncRNA),URS00009BAB70_9606(lncRNA),URS00009BB13E_9606(lncRNA),URS00009BC8FE_9606(lncRNA),URS00009BEBF4_9606(lncRNA),URS00009BF63C_9606(lncRNA),URS0000CCDF81_9606(lncRNA),URS0000CCDFCF_9606(lncRNA),URS0000CCDFDF_9606(lncRNA),URS0000CCE06F_9606(lncRNA),URS0000CCE076_9606(lncRNA),URS0000CCE0AB_9606(lncRNA),URS0000CCE0B4_9606(lncRNA),URS0000CCE0BC_9606(lncRNA),URS0000CCE0E1_9606(lncRNA),URS0000CCE108_9606(lncRNA),URS0000CCE128_9606(lncRNA),URS0000CCE14E_9606(lncRNA),URS0000D57192_9606(lncRNA),URS0000D5722B_9606(lncRNA),URS0000D57F9D_9606(lncRNA),URS0000D583DF_9606(lncRNA),URS0000D5874A_9606(lncRNA),URS0000D58A95_9606(lncRNA),URS0000D58D79_9606(lncRNA),URS0000D58E2D_9606(lncRNA),URS0000D58F0C_9606(lncRNA),URS0000D5976C_9606(lncRNA),URS0000D5A047_9606(lncRNA),URS0000D5A3CA_9606(lncRNA),URS0000D5A664_9606(lncRNA),URS0000D5A7A2_9606(lncRNA),URS0000D5AE9B_9606(lncRNA),URS0000D5B306_9606(lncRNA),URS0000D5B526_9606(lncRNA),URS0000D5BC0C_9606(lncRNA),URS0000D5C0E1_9606(lncRNA),URS0000D5C4AC_9606(lncRNA),URS0000D5C936_9606(lncRNA),URS0000D5C999_9606(lncRNA),URS0000D5CA9E_9606(lncRNA),URS0000D5CC94_9606(lncRNA),URS0000D5CE46_9606(lncRNA),URS0000D5D344_9606(lncRNA),URS0000D5DB22_9606(lncRNA),URS0000D5DF6D_9606(lncRNA),URS0000D5E3D8_9606(lncRNA),URS0000EEAEF8_9606(lncRNA),URS0000EEB6FE_9606(lncRNA),URS0000EEC386_9606(lncRNA),URS0000EEC677_9606(lncRNA),URS0000EEC7F2_9606(lncRNA),URS0000EECE76_9606(lncRNA),URS0000EEE090_9606(lncRNA),URS0000EEEED6_9606(lncRNA),URS0000EEF08F_9606(lncRNA),URS0000EEF2B0_9606(lncRNA),URS0000EEFB92_9606(lncRNA),URS0000EEFF3B_9606(lncRNA),URS0000EEFF46_9606(lncRNA),URS0000EF0DB0_9606(lncRNA),URS0000EF120E_9606(lncRNA),URS0000EF123A_9606(lncRNA),URS0000EF1858_9606(lncRNA),URS0000EF21B0_9606(lncRNA),URS0000EF2DFF_9606(lncRNA),URS0000EF301C_9606(lncRNA),URS0000EF3572_9606(lncRNA),URS0000EF37E8_9606(lncRNA),URS0000EF3A9F_9606(lncRNA),URS0000EF3CF1_9606(lncRNA),URS0000EF3DF9_9606(lncRNA),URS0000EF3F1E_9606(lncRNA),URS0000EF4F8E_9606(lncRNA),URS0000EF5E17_9606(lncRNA),URS0000EF6AE6_9606(lncRNA),URS0000EF6DD5_9606(lncRNA),URS00019EB4E2_9606(lncRNA),URS0001BC4C1F_9606(snoRNA),URS0001BCAB26_9606(lncRNA),URS0001BCB0B6_9606(lncRNA),URS0001BCCC88_9606(lncRNA),URS0001BCD596_9606(lncRNA),URS0001BD52E5_9606(lncRNA),URS0001BD61A6_9606(lncRNA),URS0001BD6BA6_9606(lncRNA),URS0001BD6FE6_9606(snoRNA),URS0001BD846E_9606(lncRNA),URS0001BD9C2E_9606(lncRNA),URS0001BDD58E_9606(lncRNA),URS0001BDF7F4_9606(lncRNA),URS0001BDFE60_9606(lncRNA),URS0001BE1ECE_9606(lncRNA),URS0001BE2C73_9606(lncRNA),URS0001BE5B4C_9606(lncRNA),URS0001BE719F_9606(lncRNA),URS0001BE7311_9606(lncRNA),URS0001BE75DE_9606(lncRNA),URS0001BE9A8D_9606(lncRNA),URS0001BEA6C7_9606(lncRNA),URS0001BEE0F5_9606(lncRNA),URS0001BEFAFF_9606(lncRNA),URS0001BF0F3B_9606(lncRNA),URS0001BF2ABE_9606(lncRNA),URS0001BF7152_9606(lncRNA),URS0001BF78F6_9606(lncRNA),URS0001BF8051_9606(lncRNA),URS0001BF8847_9606(lncRNA),URS0001BF918D_9606(lncRNA),URS0001BF9715_9606(lncRNA),URS0001BF9F44_9606(lncRNA),URS0001C778E7_9606(lncRNA),URS0001E80857_9606(lncRNA),URS000224B7D5_9606(lncRNA),URS0002262841_9606(lncRNA),URS000226E769_9606(lncRNA),URS00022AF335_9606(lncRNA),URS00022AF3D3_9606(lncRNA),URS00022AF716_9606(lncRNA),URS00022AF98F_9606(lncRNA),URS00022AFC46_9606(lncRNA),URS00022B0198_9606(lncRNA),URS00022B0581_9606(lncRNA),URS00022B0956_9606(lncRNA),URS00022B0C17_9606(lncRNA),URS00022B14A8_9606(lncRNA),URS00022B2175_9606(lncRNA),URS00022B3507_9606(lncRNA),URS00022B437F_9606(lncRNA),URS00022B6E99_9606(lncRNA),URS00022B7711_9606(lncRNA),URS00022B781F_9606(lncRNA),URS00022B7FCB_9606(lncRNA),URS00022B81C8_9606(lncRNA),URS00022B81D1_9606(lncRNA),URS00022B82C5_9606(lncRNA),URS00022B87F3_9606(lncRNA),URS00022B87F5_9606(lncRNA),URS00022B8E00_9606(lncRNA)	A	SM-ONLY
chr1	173865957	173866029	-	4265	4265	0	GAS5(lncRNA),URS00002BE588_9606(snoRNA),URS00004C8BCF_9606(snoRNA),URS00006B8984_9606(snoRNA),URS000072F791_9606(snoRNA),URS0000816F9C_9606(snoRNA),URS00008B3431_9606(lncRNA),URS00008B3C85_9606(lncRNA),URS00008B4DAD_9606(lncRNA),URS00008B6DB9_9606(lncRNA),URS00008B7CE9_9606(lncRNA),URS00008B883D_9606(lncRNA),URS00008B991F_9606(lncRNA),URS00008BB2ED_9606(lncRNA),URS00008BC666_9606(lncRNA),URS00008BD472_9606(lncRNA),URS00008C0058_9606(lncRNA),URS00008C090E_9606(lncRNA),URS00008C0A79_9606(lncRNA),URS00008C0C72_9606(lncRNA),URS00008C0D76_9606(lncRNA),URS00008C15F6_9606(lncRNA),URS00008C19D0_9606(lncRNA),URS00008C1BCE_9606(lncRNA),URS00008C2157_9606(lncRNA),URS00008C2BF5_9606(lncRNA),URS00008C2E96_9606(lncRNA),URS00008C371B_9606(lncRNA),URS00008C3A01_9606(lncRNA),URS00008C4009_9606(lncRNA),URS00009AE664_9606(lncRNA),URS00009AE80F_9606(lncRNA),URS00009AEE8E_9606(lncRNA),URS00009B629F_9606(lncRNA),URS00009BA636_9606(lncRNA),URS00009BBB44_9606(lncRNA),URS00009BCE1D_9606(lncRNA),URS00009BED68_9606(lncRNA),URS00009C227F_9606(lncRNA),URS00009C4337_9606(lncRNA),URS00009C4AE5_9606(lncRNA),URS0000A80260_9606(lncRNA),URS0000AB0ACF_9606(lncRNA),URS0000CCDF7F_9606(lncRNA),URS0000CCDFCD_9606(lncRNA),URS0000CCDFEE_9606(lncRNA),URS0000CCE004_9606(lncRNA),URS0000CCE03F_9606(lncRNA),URS0000CCE053_9606(lncRNA),URS0000CCE07A_9606(lncRNA),URS0000CCE0B6_9606(lncRNA),URS0000CCE0C1_9606(lncRNA),URS0000CCE0C7_9606(lncRNA),URS0000CCE0E6_9606(lncRNA),URS0000CCE0FF_9606(lncRNA),URS0000CCE104_9606(lncRNA),URS0000CCE10E_9606(lncRNA),URS0000CCE12A_9606(lncRNA),URS0000D56DBC_9606(lncRNA),URS0000D574C4_9606(lncRNA),URS0000D57AAB_9606(lncRNA),URS0000D57C33_9606(lncRNA),URS0000D57C9D_9606(lncRNA),URS0000D580E5_9606(lncRNA),URS0000D58B68_9606(lncRNA),URS0000D58CB2_9606(lncRNA),URS0000D58D56_9606(lncRNA),URS0000D58E93_9606(lncRNA),URS0000D5948E_9606(lncRNA),URS0000D59535_9606(lncRNA),URS0000D5A48C_9606(lncRNA),URS0000D5A608_9606(lncRNA),URS0000D5A76D_9606(lncRNA),URS0000D5AA2B_9606(lncRNA),URS0000D5AB45_9606(lncRNA),URS0000D5B449_9606(lncRNA),URS0000D5B48A_9606(lncRNA),URS0000D5C1C4_9606(lncRNA),URS0000D5C34A_9606(lncRNA),URS0000D5C393_9606(lncRNA),URS0000D5C3C1_9606(lncRNA),URS0000D5C5C1_9606(lncRNA),URS0000D5C60C_9606(lncRNA),URS0000D5C735_9606(lncRNA),URS0000D5C88D_9606(lncRNA),URS0000D5CD7C_9606(lncRNA),URS0000D5CE9A_9606(lncRNA),URS0000D5D155_9606(lncRNA),URS0000D5D3F7_9606(lncRNA),URS0000D5D74F_9606(lncRNA),URS0000D5DB9C_9606(lncRNA),URS0000EA0F94_9606(lncRNA),URS0000EF4377_9606(lncRNA),URS00019BF8D5_9606(lncRNA),URS0001BC4715_9606(snoRNA),URS0001BCCF8B_9606(lncRNA),URS0001BCD56D_9606(lncRNA),URS0001BCD741_9606(lncRNA),URS0001BCDE3D_9606(lncRNA),URS0001BCE45E_9606(lncRNA),URS0001BCF2DD_9606(lncRNA),URS0001BD044C_9606(lncRNA),URS0001BD1A51_9606(lncRNA),URS0001BD3771_9606(lncRNA),URS0001BD3FEF_9606(lncRNA),URS0001BD4316_9606(lncRNA),URS0001BD50F2_9606(lncRNA),URS0001BD549F_9606(lncRNA),URS0001BD6878_9606(lncRNA),URS0001BD6EFB_9606(lncRNA),URS0001BD742C_9606(lncRNA),URS0001BD8757_9606(lncRNA),URS0001BDAB6D_9606(lncRNA),URS0001BDBD5F_9606(lncRNA),URS0001BDC64F_9606(lncRNA),URS0001BE02C6_9606(lncRNA),URS0001BE0468_9606(lncRNA),URS0001BE169A_9606(lncRNA),URS0001BE1BF4_9606(lncRNA),URS0001BE1F67_9606(lncRNA),URS0001BE2106_9606(lncRNA),URS0001BE22CC_9606(lncRNA),URS0001BE30C4_9606(lncRNA),URS0001BE4E6D_9606(lncRNA),URS0001BE55B9_9606(lncRNA),URS0001BE6D3C_9606(lncRNA),URS0001BE73B4_9606(lncRNA),URS0001BE9684_9606(lncRNA),URS0001BEA36A_9606(lncRNA),URS0001BEA4A7_9606(lncRNA),URS0001BEA965_9606(lncRNA),URS0001BEAF6D_9606(lncRNA),URS0001BEB416_9606(lncRNA),URS0001BED74D_9606(lncRNA),URS0001BEFBA2_9606(lncRNA),URS0001BEFBA8_9606(lncRNA),URS0001BEFF33_9606(lncRNA),URS0001BF0144_9606(lncRNA),URS0001BF03AF_9606(lncRNA),URS0001BF107B_9606(lncRNA),URS0001BF2483_9606(lncRNA),URS0001BF28F7_9606(lncRNA),URS0001BF5440_9606(lncRNA),URS0001BF738C_9606(lncRNA),URS0001BF8218_9606(lncRNA),URS0001BF8EC8_9606(lncRNA),URS0001BF9C77_9606(lncRNA),URS0001BF9F5D_9606(lncRNA),URS0001BFA1B0_9606(lncRNA),URS0001BFA68C_9606(lncRNA),URS00021FBAD5_9606(lncRNA),URS0002218A4A_9606(lncRNA),URS0002276C2D_9606(lncRNA),URS00022AE845_9606(lncRNA),URS00022AEE19_9606(lncRNA),URS00022AEEFE_9606(lncRNA),URS00022AF133_9606(lncRNA),URS00022B0225_9606(lncRNA),URS00022B0C15_9606(lncRNA),URS00022B137A_9606(lncRNA),URS00022B15AA_9606(lncRNA),URS00022B1858_9606(lncRNA),URS00022B1EF5_9606(lncRNA),URS00022B2095_9606(lncRNA),URS00022B21B2_9606(lncRNA),URS00022B2236_9606(lncRNA),URS00022B23C3_9606(lncRNA),URS00022B2A25_9606(lncRNA),URS00022B30ED_9606(lncRNA),URS00022B3120_9606(lncRNA),URS00022B3949_9606(lncRNA),URS00022B3A51_9606(lncRNA),URS00022B3D16_9606(lncRNA),URS00022B3D8A_9606(lncRNA),URS00022B3E09_9606(lncRNA),URS00022B3EF9_9606(lncRNA),URS00022B3FAD_9606(lncRNA),URS00022B45C4_9606(lncRNA),URS00022B461B_9606(lncRNA),URS00022B4821_9606(lncRNA),URS00022B4B51_9606(lncRNA),URS00022B575C_9606(lncRNA),URS00022B591C_9606(lncRNA),URS00022B5B49_9606(lncRNA),URS00022B5EC0_9606(lncRNA),URS00022B671C_9606(lncRNA),URS00022B74A0_9606(lncRNA),URS00022B7566_9606(lncRNA),URS00022B77FD_9606(lncRNA),URS00022B7A55_9606(lncRNA),URS00022B8675_9606(lncRNA),URS00022B8D24_9606(lncRNA),URS00022B8E31_9606(lncRNA),URS00022B8E3A_9606(lncRNA),URS00022B8FB5_9606(lncRNA),URS00022B8FC7_9606(lncRNA),URS00022B9426_9606(lncRNA),URS00022B9481_9606(lncRNA),URS00022B962E_9606(lncRNA)	A	SM-ONLY
chr22	39319044	39319113	-	3158	3158	0	RPL3(protein_coding),SNORD43(snoRNA),URS000019516C_9606(piRNA),URS000022EFB6_9606(snoRNA),URS000063F175_9606(snoRNA),URS0000D6DFE9_9606(lncRNA),URS0000D6E3D3_9606(lncRNA),URS0000D6E5F4_9606(lncRNA),URS0000D6E6AD_9606(lncRNA),URS0001BC23F4_9606(snoRNA)	A	SM-PC
chr17	64146080	64146132	+	2936	2936	0	SNORD104(snoRNA),URS00000C304D_9606(snoRNA),URS00000F1597_9606(lncRNA),URS0000428A90_9606(snoRNA),URS00004855ED_9606(lncRNA),URS00006F39E7_9606(snoRNA),URS00008B89CA_9606(lncRNA),URS0000D5C530_9606(lncRNA),URS0000E97600_9606(lncRNA),URS0000EADDE0_9606(lncRNA),URS0001BC67CE_9606(snoRNA),URS0001BC6816_9606(snoRNA),URS00022B50F9_9606(lncRNA),URS00022B6B63_9606(lncRNA)	A	SM-ONLY
chr16	89561428	89561480	+	2844	2844	0	RPL13(protein_coding),SNORD68(snoRNA),URS00001CE783_9606(piRNA),URS0000714052_9606(snoRNA),URS000075D268_9606(snoRNA),URS00009AE70C_9606(lncRNA),URS00009B9D4D_9606(lncRNA),URS0001BC3E9D_9606(snoRNA),URS0001BE879C_9606(lncRNA)	A	SM-PC
chr3	186784797	186784850	+	1930	1930	0	EIF4A2(protein_coding),SNORD2(snoRNA),URS0000651282_9606(snoRNA),URS000075E9C3_9606(snoRNA)	A	SM-PC
chr20	49280324	49280376	+	1837	1837	0	SNORD12B(snoRNA),URS00000C1202_9606(lncRNA),URS0000114181_9606(lncRNA),URS00001AEC9F_9606(lncRNA),URS00002172FF_9606(lncRNA),URS000023559A_9606(lncRNA),URS000045E7E2_9606(lncRNA),URS00004B003D_9606(lncRNA),URS0000643FAE_9606(snoRNA),URS000075BC17_9606(snoRNA),URS000078514C_9606(lncRNA),URS00007CF26E_9606(lncRNA),URS00009B1321_9606(lncRNA),URS00009B254D_9606(lncRNA),URS00009B475D_9606(lncRNA),URS0000BC464D_9606(lncRNA),URS0000D57061_9606(lncRNA),URS0000D57BFF_9606(lncRNA),URS0000D581D5_9606(lncRNA),URS0000D58FA8_9606(lncRNA),URS0000D59374_9606(lncRNA),URS0000D59719_9606(lncRNA),URS0000D5A915_9606(lncRNA),URS0000D5B6B6_9606(lncRNA),URS0000D5BA6C_9606(lncRNA),URS0000D5C754_9606(lncRNA),URS0000D5D705_9606(lncRNA),URS0000D5DEE0_9606(lncRNA),URS0000D5E35E_9606(lncRNA),URS0000E9EF51_9606(lncRNA),URS0000EEBD6C_9606(lncRNA),URS0000EEC5E7_9606(lncRNA),URS0000EF03BE_9606(lncRNA),URS0000EF18F5_9606(lncRNA),URS0000EF220C_9606(lncRNA),URS0001BC2E6D_9606(snoRNA),URS0001BD5F9D_9606(lncRNA),URS0001BDCB37_9606(lncRNA),URS0001BE4A10_9606(lncRNA),URS0001BE5A20_9606(lncRNA),URS0001BE98BC_9606(lncRNA),URS0001BF1393_9606(lncRNA),URS0001D6A50B_9606(lncRNA),ZFAS1(lncRNA)	A	SM-ONLY
chr17	28723429	28723498	+	1575	1575	0	RPL23A(protein_coding),SNORD42A(snoRNA),URS0000583A29_9606(snoRNA),URS00006C0C10_9606(snoRNA),URS00006F0D71_9606(snoRNA),URS000075B547_9606(snoRNA),URS000082C6B1_9606(snoRNA),URS0001BC0678_9606(snoRNA),URS0001BC66D6_9606(snoRNA),URS0001BED105_9606(lncRNA),URS00022AE7D9_9606(snoRNA)	A	SM-PC
chr6	31835262	31835315	+	1497	1497	0	SNHG32(lncRNA),SNORD48(snoRNA),URS0000712944_9606(snoRNA),URS0000DB6BEA_9606(lncRNA),URS0000DB6ECC_9606(lncRNA),URS0000DB6F39_9606(lncRNA),URS0000DB75BB_9606(lncRNA),URS0000DB830E_9606(lncRNA),URS0000DB8775_9606(lncRNA),URS0000DB9437_9606(lncRNA),URS0000DBB57F_9606(lncRNA),URS0000E60A00_9606(lncRNA),URS0000E60A1F_9606(lncRNA),URS0000E60A4F_9606(lncRNA),URS0000E60AA1_9606(lncRNA),URS0000E60AB7_9606(lncRNA),URS0000E60AE4_9606(lncRNA),URS0000E60AE9_9606(lncRNA),URS0000E60B24_9606(lncRNA),URS0000E60B25_9606(lncRNA),URS0000EA5ADA_9606(lncRNA),URS0000EA9C36_9606(lncRNA),URS0000EF5D28_9606(lncRNA),URS0001962C0B_9606(lncRNA),URS0001BC9A38_9606(snoRNA),URS0001BCAE5F_9606(lncRNA),URS0001BCD55E_9606(lncRNA),URS0001BE7145_9606(lncRNA),URS0001BEFF0E_9606(lncRNA)	A	SM-ONLY
chr20	49278945	49278997	+	1144	1144	0	SNORD12C(snoRNA),URS00000C1202_9606(lncRNA),URS0000114181_9606(lncRNA),URS00001AEC9F_9606(lncRNA),URS00002172FF_9606(lncRNA),URS000023559A_9606(lncRNA),URS0000359B05_9606(snoRNA),URS000045E7E2_9606(lncRNA),URS00004B003D_9606(lncRNA),URS000071403B_9606(snoRNA),URS000078514C_9606(lncRNA),URS00009B1321_9606(lncRNA),URS00009B254D_9606(lncRNA),URS00009B475D_9606(lncRNA),URS0000BC464D_9606(lncRNA),URS0000D57061_9606(lncRNA),URS0000D57BFF_9606(lncRNA),URS0000D581D5_9606(lncRNA),URS0000D58FA8_9606(lncRNA),URS0000D59374_9606(lncRNA),URS0000D59719_9606(lncRNA),URS0000D5A915_9606(lncRNA),URS0000D5B6B6_9606(lncRNA),URS0000D5BA6C_9606(lncRNA),URS0000D5C754_9606(lncRNA),URS0000D5D705_9606(lncRNA),URS0000D5DEE0_9606(lncRNA),URS0000D5E35E_9606(lncRNA),URS0000E9EF51_9606(lncRNA),URS0000EEBD6C_9606(lncRNA),URS0000EEC5E7_9606(lncRNA),URS0000EF03BE_9606(lncRNA),URS0000EF220C_9606(lncRNA),URS0000EF4FA0_9606(lncRNA),URS0001BC182B_9606(snoRNA),URS0001BC4330_9606(snoRNA),URS0001BD5F9D_9606(lncRNA),URS0001BE4A10_9606(lncRNA),URS0001BE5A20_9606(lncRNA),URS0001BE98BC_9606(lncRNA),URS0001BF1393_9606(lncRNA),URS0001D6A50B_9606(lncRNA)	A	SM-ONLY
chr2	231460370	231460438	-	1034	1034	0	SNORD82(snoRNA),URS00005160A3_9606(snoRNA),URS0000519855_9606(snoRNA),URS000057BC8B_9606(piRNA),URS0000626A32_9606(snoRNA),URS00006A2AF1_9606(snoRNA),URS000081644F_9606(snoRNA),URS0001BC1386_9606(snoRNA),URS0001BC38A4_9606(snoRNA)	A	SM-ONLY
chr11	62855314	62855366	-	900	900	0	SNHG1(lncRNA),SNORD26(snoRNA),URS0000197BB5_9606(snoRNA),URS00005F4016_9606(misc_RNA),URS00008C0C32_9606(lncRNA),URS00008C0CC6_9606(lncRNA),URS00008C1085_9606(lncRNA),URS00008C12CA_9606(lncRNA),URS00008C1508_9606(lncRNA),URS00008C167B_9606(lncRNA),URS00008C191F_9606(lncRNA),URS00008C1A56_9606(lncRNA),URS00008C1CD0_9606(lncRNA),URS00008C1D08_9606(lncRNA),URS00008C2147_9606(lncRNA),URS00008C22A8_9606(lncRNA),URS00008C22F5_9606(lncRNA),URS00008C2432_9606(lncRNA),URS00008C24BC_9606(lncRNA),URS00008C2EDC_9606(lncRNA),URS00008C355C_9606(lncRNA),URS00008C392D_9606(lncRNA),URS00008C3E49_9606(lncRNA),URS00008C409D_9606(lncRNA),URS00009B63CD_9606(lncRNA),URS00009B9E39_9606(lncRNA),URS00009BB13E_9606(lncRNA),URS00009BC8FE_9606(lncRNA),URS00009BF63C_9606(lncRNA),URS0000CCDF81_9606(lncRNA),URS0000CCDFCF_9606(lncRNA),URS0000CCDFDF_9606(lncRNA),URS0000CCE06F_9606(lncRNA),URS0000CCE076_9606(lncRNA),URS0000CCE0AB_9606(lncRNA),URS0000CCE0B4_9606(lncRNA),URS0000CCE0BC_9606(lncRNA),URS0000CCE0E1_9606(lncRNA),URS0000CCE108_9606(lncRNA),URS0000CCE128_9606(lncRNA),URS0000CCE14E_9606(lncRNA),URS0000D57192_9606(lncRNA),URS0000D5722B_9606(lncRNA),URS0000D577F5_9606(lncRNA),URS0000D57F9D_9606(lncRNA),URS0000D583DF_9606(lncRNA),URS0000D5874A_9606(lncRNA),URS0000D58A95_9606(lncRNA),URS0000D58D79_9606(lncRNA),URS0000D58E2D_9606(lncRNA),URS0000D58F0C_9606(lncRNA),URS0000D58F7B_9606(lncRNA),URS0000D5976C_9606(lncRNA),URS0000D5A047_9606(lncRNA),URS0000D5A3CA_9606(lncRNA),URS0000D5A664_9606(lncRNA),URS0000D5ACC0_9606(lncRNA),URS0000D5AE9B_9606(lncRNA),URS0000D5B306_9606(lncRNA),URS0000D5B526_9606(lncRNA),URS0000D5B874_9606(lncRNA),URS0000D5C0E1_9606(lncRNA),URS0000D5C4AC_9606(lncRNA),URS0000D5C936_9606(lncRNA),URS0000D5C999_9606(lncRNA),URS0000D5CA9E_9606(lncRNA),URS0000D5CE46_9606(lncRNA),URS0000D5D344_9606(lncRNA),URS0000D5D697_9606(lncRNA),URS0000D5DB22_9606(lncRNA),URS0000D5DF6D_9606(lncRNA),URS0000D5E3D8_9606(lncRNA),URS0000EEAEF8_9606(lncRNA),URS0000EEB6FE_9606(lncRNA),URS0000EEC386_9606(lncRNA),URS0000EEC677_9606(lncRNA),URS0000EEC7F2_9606(lncRNA),URS0000EECE76_9606(lncRNA),URS0000EEE090_9606(lncRNA),URS0000EEEED6_9606(lncRNA),URS0000EEF08F_9606(lncRNA),URS0000EEF2B0_9606(lncRNA),URS0000EEFB92_9606(lncRNA),URS0000EEFF3B_9606(lncRNA),URS0000EEFF46_9606(lncRNA),URS0000EF0DB0_9606(lncRNA),URS0000EF120E_9606(lncRNA),URS0000EF123A_9606(lncRNA),URS0000EF1858_9606(lncRNA),URS0000EF21B0_9606(lncRNA),URS0000EF2DFF_9606(lncRNA),URS0000EF301C_9606(lncRNA),URS0000EF37E8_9606(lncRNA),URS0000EF3A9F_9606(lncRNA),URS0000EF3CF1_9606(lncRNA),URS0000EF3DF9_9606(lncRNA),URS0000EF3F1E_9606(lncRNA),URS0000EF4F8E_9606(lncRNA),URS0000EF5E17_9606(lncRNA),URS0000EF6AE6_9606(lncRNA),URS0000EF6DD5_9606(lncRNA),URS00019EB4E2_9606(lncRNA),URS0001BC1D16_9606(snoRNA),URS0001BCAB26_9606(lncRNA),URS0001BCB0B6_9606(lncRNA),URS0001BCCC88_9606(lncRNA),URS0001BD06A8_9606(lncRNA),URS0001BD6BA6_9606(lncRNA),URS0001BD6FE6_9606(snoRNA),URS0001BD846E_9606(lncRNA),URS0001BD9C2E_9606(lncRNA),URS0001BDD58E_9606(lncRNA),URS0001BDF7F4_9606(lncRNA),URS0001BDFE60_9606(lncRNA),URS0001BE1ECE_9606(lncRNA),URS0001BE5B4C_9606(lncRNA),URS0001BE719F_9606(lncRNA),URS0001BE7311_9606(lncRNA),URS0001BE75DE_9606(lncRNA),URS0001BE9A8D_9606(lncRNA),URS0001BEA6C7_9606(lncRNA),URS0001BEE0F5_9606(lncRNA),URS0001BEFAFF_9606(lncRNA),URS0001BF0F3B_9606(lncRNA),URS0001BF2ABE_9606(lncRNA),URS0001BF32E6_9606(lncRNA),URS0001BF7152_9606(lncRNA),URS0001BF78F6_9606(lncRNA),URS0001BF8051_9606(lncRNA),URS0001BF8847_9606(lncRNA),URS0001BF88A5_9606(lncRNA),URS0001BF918D_9606(lncRNA),URS0001BF9715_9606(lncRNA),URS0001BF9F44_9606(lncRNA),URS0001C778E7_9606(lncRNA),URS0001E80857_9606(lncRNA),URS000224B7D5_9606(lncRNA),URS0002262841_9606(lncRNA),URS000226E769_9606(lncRNA),URS00022AF335_9606(lncRNA),URS00022AF3D3_9606(lncRNA),URS00022AF716_9606(lncRNA),URS00022AF98F_9606(lncRNA),URS00022AFC46_9606(lncRNA),URS00022B0198_9606(lncRNA),URS00022B0581_9606(lncRNA),URS00022B0956_9606(lncRNA),URS00022B0C17_9606(lncRNA),URS00022B14A8_9606(lncRNA),URS00022B2175_9606(lncRNA),URS00022B3507_9606(lncRNA),URS00022B437F_9606(lncRNA),URS00022B6E99_9606(lncRNA),URS00022B7711_9606(lncRNA),URS00022B781F_9606(lncRNA),URS00022B7FCB_9606(lncRNA),URS00022B81C8_9606(lncRNA),URS00022B81D1_9606(lncRNA),URS00022B82C5_9606(lncRNA),URS00022B87F3_9606(lncRNA),URS00022B87F5_9606(lncRNA),URS00022B8E00_9606(lncRNA)	A	SM-ONLY
chr20	49280687	49280767	+	826	826	0	SNORD12(snoRNA),URS00000C1202_9606(lncRNA),URS0000114181_9606(lncRNA),URS00001AEC9F_9606(lncRNA),URS00002172FF_9606(lncRNA),URS000023559A_9606(lncRNA),URS000045E7E2_9606(lncRNA),URS00004B003D_9606(lncRNA),URS00006B5455_9606(snoRNA),URS000078514C_9606(lncRNA),URS00007CF26E_9606(lncRNA),URS00009B1321_9606(lncRNA),URS00009B254D_9606(lncRNA),URS00009B475D_9606(lncRNA),URS0000BC464D_9606(lncRNA),URS0000D57061_9606(lncRNA),URS0000D57BFF_9606(lncRNA),URS0000D581D5_9606(lncRNA),URS0000D58FA8_9606(lncRNA),URS0000D59374_9606(lncRNA),URS0000D59719_9606(lncRNA),URS0000D5A7EC_9606(lncRNA),URS0000D5A915_9606(lncRNA),URS0000D5B6B6_9606(lncRNA),URS0000D5BA6C_9606(lncRNA),URS0000D5C754_9606(lncRNA),URS0000D5D705_9606(lncRNA),URS0000D5DEE0_9606(lncRNA),URS0000D5E35E_9606(lncRNA),URS0000D5E3F5_9606(lncRNA),URS0000E9EF51_9606(lncRNA),URS0000EEBD6C_9606(lncRNA),URS0000EEC5E7_9606(lncRNA),URS0000EF03BE_9606(lncRNA),URS0000EF18F5_9606(lncRNA),URS0000EF220C_9606(lncRNA),URS0001BC25F1_9606(snoRNA),URS0001BD5F9D_9606(lncRNA),URS0001BDCB37_9606(lncRNA),URS0001BE0B73_9606(lncRNA),URS0001BE4A10_9606(lncRNA),URS0001BE5A20_9606(lncRNA),URS0001BE98BC_9606(lncRNA),URS0001BF1393_9606(lncRNA),URS0001BF281D_9606(lncRNA),URS0001D6A50B_9606(lncRNA),ZFAS1(lncRNA)	A	SM-ONLY
chr2	25245096	25245148	-	765	765	0	NA	U	Novel
chr19	12703591	12703668	-	760	758	2	URS00008E3980_9606(snoRNA),URS0000BE73CF_9606(snoRNA),URS0000D50918_9606(pre_miRNA),URS0000D52042_9606(miRNA),URS0000D53F1E_9606(miRNA),URS00019F752D_9606(lncRNA),URS0001BC67D6_9606(snoRNA)	A	SM-ONLY
chr1	28578748	28578820	-	714	714	0	SNORD99(snoRNA),URS00000537B8_9606(lncRNA),URS00000862C0_9606(lncRNA),URS00001DF136_9606(lncRNA),URS000025B268_9606(lncRNA),URS000046444E_9606(lncRNA),URS00004670AA_9606(lncRNA),URS000051CB3A_9606(lncRNA),URS0000579998_9606(lncRNA),URS00005A2E0D_9606(lncRNA),URS00005F87D2_9606(lncRNA),URS00006E3D71_9606(snoRNA),URS000075A722_9606(snoRNA),URS00007B872B_9606(lncRNA),URS00008C23DF_9606(lncRNA),URS00009B0AC5_9606(lncRNA),URS00009C35C3_9606(lncRNA),URS0000BC442C_9606(lncRNA),URS0000BC4490_9606(lncRNA),URS0000BC44B4_9606(lncRNA),URS0000BC4513_9606(lncRNA),URS0000BC4546_9606(lncRNA),URS0000BC45AE_9606(lncRNA),URS0000BC4602_9606(lncRNA),URS0000BC465C_9606(lncRNA),URS0000D576A5_9606(lncRNA),URS0000D57843_9606(lncRNA),URS0000D5785C_9606(lncRNA),URS0000D5790B_9606(lncRNA),URS0000D58B67_9606(lncRNA),URS0000D58C32_9606(lncRNA),URS0000D5A5C7_9606(lncRNA),URS0000D5AB09_9606(lncRNA),URS0000D5C130_9606(lncRNA),URS0000D5C2E5_9606(lncRNA),URS0000D5DC2E_9606(lncRNA),URS0000DB8160_9606(lncRNA),URS0000DB820B_9606(lncRNA),URS0000DB9F83_9606(lncRNA),URS0000DBA9ED_9606(lncRNA),URS0000EB008B_9606(lncRNA),URS0001BC7382_9606(snoRNA),URS0001BCB857_9606(lncRNA),URS0001BCEC40_9606(lncRNA),URS0001BCF12F_9606(lncRNA),URS0001BCF1D0_9606(lncRNA),URS0001BD0A0E_9606(lncRNA),URS0001BD254E_9606(lncRNA),URS0001BD2DCF_9606(lncRNA),URS0001BD6117_9606(lncRNA),URS0001BD6402_9606(lncRNA),URS0001BD79E8_9606(lncRNA),URS0001BD89E1_9606(lncRNA),URS0001BD9081_9606(lncRNA),URS0001BDA64E_9606(lncRNA),URS0001BDBDCF_9606(lncRNA),URS0001BDC698_9606(lncRNA),URS0001BE0422_9606(lncRNA),URS0001BE170A_9606(lncRNA),URS0001BE2149_9606(lncRNA),URS0001BE22E7_9606(lncRNA),URS0001BE28D5_9606(lncRNA),URS0001BE57B1_9606(lncRNA),URS0001BE5C45_9606(lncRNA),URS0001BE5FC2_9606(lncRNA),URS0001BE5FEC_9606(lncRNA),URS0001BE7AC8_9606(lncRNA),URS0001BE992B_9606(lncRNA),URS0001BEA783_9606(lncRNA),URS0001BEABB5_9606(lncRNA),URS0001BEAE02_9606(lncRNA),URS0001BEB6F0_9606(lncRNA),URS0001BEBC93_9606(lncRNA),URS0001BECE89_9606(lncRNA),URS0001BEF256_9606(lncRNA),URS0001BF152B_9606(lncRNA),URS0001BF1990_9606(lncRNA),URS0001BF3370_9606(lncRNA),URS0001BF3384_9606(lncRNA),URS0001BF3889_9606(lncRNA),URS0001BF5AF0_9606(lncRNA),URS0001BF6B80_9606(lncRNA),URS0001BF7839_9606(lncRNA),URS0001C3FBB6_9606(lncRNA),URS0001EDAD53_9606(lncRNA),URS0002201A3F_9606(lncRNA),URS000224406D_9606(lncRNA),URS0002244A24_9606(lncRNA),URS0002259073_9606(lncRNA),URS00022678C1_9606(lncRNA),URS0002273A4D_9606(lncRNA),URS0002278130_9606(lncRNA),URS00022AEAD2_9606(lncRNA),URS00022B11C3_9606(lncRNA),URS00022B4A15_9606(lncRNA)	A	SM-ONLY
chr1	75787887	75787978	+	692	692	0	RABGGTB(protein_coding),SNORD45A(snoRNA),URS00000A3335_9606(snoRNA),URS00008295AD_9606(snoRNA),URS00008BB85C_9606(lncRNA),URS00009BA4AC_9606(lncRNA),URS00009BB286_9606(lncRNA),URS00009C40F8_9606(lncRNA),URS0001BC3655_9606(snoRNA),URS0001BEBDCB_9606(lncRNA)	A	SM-PC
chr13	27255064	27255117	+	679	679	0	RPL21(protein_coding),SNORD102(snoRNA),URS00003034E3_9606(snoRNA),URS0000446770_9606(snoRNA),URS00009B57A9_9606(lncRNA),URS00009B84A9_9606(lncRNA),URS0001BC2DC6_9606(snoRNA),URS0001BE3FB4_9606(lncRNA)	A	SM-PC
chr6	85677317	85677369	-	661	661	0	SNHG5(lncRNA),URS000001388A_9606(snoRNA),URS00002524EE_9606(snoRNA),URS000075B42D_9606(lncRNA),URS00008C0996_9606(lncRNA),URS00008C10C0_9606(lncRNA),URS00008C1525_9606(lncRNA),URS00008C17FC_9606(lncRNA),URS00008C1E78_9606(lncRNA),URS00008C2D93_9606(lncRNA),URS00008C390C_9606(lncRNA),URS00008C3D3F_9606(lncRNA),URS00009AD3AE_9606(lncRNA),URS00009AD95F_9606(lncRNA),URS00009AFEAD_9606(lncRNA),URS00009B0872_9606(lncRNA),URS00009B2777_9606(lncRNA),URS00009B6A3B_9606(lncRNA),URS00009B6DEE_9606(lncRNA),URS00009B7C98_9606(lncRNA),URS00009B815E_9606(lncRNA),URS00009B850F_9606(lncRNA),URS00009B8CAA_9606(lncRNA),URS00009BA38D_9606(lncRNA),URS00009C0048_9606(lncRNA),URS00009C1433_9606(lncRNA),URS00009C2139_9606(lncRNA),URS00009C3297_9606(lncRNA),URS00009C3819_9606(lncRNA),URS0000A7981B_9606(lncRNA),URS0000AB0B09_9606(lncRNA),URS0000D575C4_9606(lncRNA),URS0000D57E2C_9606(lncRNA),URS0000D5834F_9606(lncRNA),URS0000D5837F_9606(lncRNA),URS0000D58450_9606(lncRNA),URS0000D584F8_9606(lncRNA),URS0000D59050_9606(lncRNA),URS0000D59687_9606(lncRNA),URS0000D5A9ED_9606(lncRNA),URS0000D5B094_9606(lncRNA),URS0000D5BC42_9606(lncRNA),URS0000D5C0B4_9606(lncRNA),URS0000D5D6A9_9606(lncRNA),URS0000D5D7D6_9606(lncRNA),URS0000D5DA2B_9606(lncRNA),URS0000D5DB14_9606(lncRNA),URS0000D5E0D2_9606(lncRNA),URS0000DBA17D_9606(lncRNA),URS0000EA21A5_9606(lncRNA),URS0000EEB4B8_9606(lncRNA),URS0000EEB61A_9606(lncRNA),URS0000EEB94D_9606(lncRNA),URS0000EEBA21_9606(lncRNA),URS0000EEC256_9606(lncRNA),URS0000EEC34C_9606(lncRNA),URS0000EEC9D1_9606(lncRNA),URS0000EECBCA_9606(lncRNA),URS0000EED3D3_9606(lncRNA),URS0000EED8C4_9606(lncRNA),URS0000EEDC2D_9606(lncRNA),URS0000EEE093_9606(lncRNA),URS0000EEE2E9_9606(lncRNA),URS0000EEE462_9606(lncRNA),URS0000EEE586_9606(lncRNA),URS0000EEEEC0_9606(lncRNA),URS0000EEF176_9606(lncRNA),URS0000EEF3B3_9606(lncRNA),URS0000EEF4D1_9606(lncRNA),URS0000EEF5B1_9606(lncRNA),URS0000EEF5E0_9606(lncRNA),URS0000EEF712_9606(lncRNA),URS0000EEFA14_9606(lncRNA),URS0000EEFA95_9606(lncRNA),URS0000EEFE28_9606(lncRNA),URS0000EEFE66_9606(lncRNA),URS0000EEFF0C_9606(lncRNA),URS0000EF027D_9606(lncRNA),URS0000EF0557_9606(lncRNA),URS0000EF0C79_9606(lncRNA),URS0000EF110D_9606(lncRNA),URS0000EF16A6_9606(lncRNA),URS0000EF194C_9606(lncRNA),URS0000EF1CF6_9606(lncRNA),URS0000EF1D15_9606(lncRNA),URS0000EF1D5D_9606(lncRNA),URS0000EF2495_9606(lncRNA),URS0000EF26A6_9606(lncRNA),URS0000EF26C6_9606(lncRNA),URS0000EF2E4C_9606(lncRNA),URS0000EF2E95_9606(lncRNA),URS0000EF2F6C_9606(lncRNA),URS0000EF33EA_9606(lncRNA),URS0000EF3A07_9606(lncRNA),URS0000EF3DF1_9606(lncRNA),URS0000EF3FEE_9606(lncRNA),URS0000EF4099_9606(lncRNA),URS0000EF4246_9606(lncRNA),URS0000EF438B_9606(lncRNA),URS0000EF4456_9606(lncRNA),URS0000EF4488_9606(lncRNA),URS0000EF44C6_9606(lncRNA),URS0000EF45AF_9606(lncRNA),URS0000EF461D_9606(lncRNA),URS0000EF4BFD_9606(lncRNA),URS0000EF4C00_9606(lncRNA),URS0000EF4E23_9606(lncRNA),URS0000EF5343_9606(lncRNA),URS0000EF540C_9606(lncRNA),URS0000EF5AF3_9606(lncRNA),URS0000EF5E15_9606(lncRNA),URS0000EF5EA9_9606(lncRNA),URS0000EF5EF1_9606(lncRNA),URS0000EF62FB_9606(lncRNA),URS0000EF6361_9606(lncRNA),URS0000EF6384_9606(lncRNA),URS0000EF6C9B_9606(lncRNA),URS0000EF6CCC_9606(lncRNA),URS0000EF6DD6_9606(lncRNA),URS0000EF6F51_9606(lncRNA),URS0000EF6FD7_9606(lncRNA),URS0000EF72DF_9606(lncRNA),URS0001987091_9606(lncRNA),URS0001989D0F_9606(lncRNA),URS000198B785_9606(lncRNA),URS000198CF16_9606(lncRNA),URS0001999DC8_9606(lncRNA),URS0001BC0DFA_9606(snoRNA),URS0001BD3B35_9606(lncRNA),URS0001BD681C_9606(lncRNA),URS0001BDD2C1_9606(lncRNA),URS0001BE0085_9606(lncRNA),URS0001BEBFDC_9606(lncRNA),URS0001BECFC0_9606(lncRNA),URS0001BF1182_9606(lncRNA),URS0001BF39F2_9606(lncRNA),URS0001BF8677_9606(lncRNA),URS000221FC42_9606(lncRNA),URS0002222E03_9606(lncRNA),URS000225D6F6_9606(lncRNA)	A	SM-ONLY
chr19	50802364	50802416	-	618	618	0	C19orf48(transcribed_unitary_pseudogene),SNORD88C(snoRNA),URS00006611EB_9606(snoRNA),URS000075A57C_9606(snoRNA),URS00008C3435_9606(lncRNA),URS0000D5989C_9606(lncRNA),URS0000D5BBC4_9606(lncRNA),URS0000D5D69C_9606(lncRNA),URS0001BC3A91_9606(snoRNA),URS0001BCDF35_9606(lncRNA),URS0001BE27EB_9606(lncRNA),URS0001BE7C23_9606(lncRNA),URS0001BF3355_9606(lncRNA)	A	SM-PS
chr9	35657961	35658020	-	523	523	0	RMRP(lncRNA),RMRP(ribozyme),URS0000051A30_9606(lncRNA),URS0000153780_9606(RNase_MRP_RNA),URS0000229D6D_9606(RNase_MRP_RNA),URS00003B7E88_9606(RNase_MRP_RNA),URS0000547024_9606(RNase_MRP_RNA),URS00005B510E_9606(RNase_MRP_RNA),URS00006D8FF2_9606(lncRNA),URS000075C8FA_9606(RNase_MRP_RNA),URS0000D5B596_9606(lncRNA),URS0001BC2856_9606(RNase_MRP_RNA),URS0001BC3C9B_9606(RNase_MRP_RNA)	A	NO-SM
chr1	173864167	173864219	-	515	515	0	GAS5(lncRNA),URS00000692DE_9606(snoRNA),URS0000090EE8_9606(piRNA),URS0000202D9F_9606(misc_RNA),URS000044A65C_9606(piRNA),URS000069573D_9606(snoRNA),URS000072F791_9606(snoRNA),URS00008B3431_9606(lncRNA),URS00008B3C85_9606(lncRNA),URS00008B41F4_9606(lncRNA),URS00008B4DAD_9606(lncRNA),URS00008B4E64_9606(lncRNA),URS00008B6DB9_9606(lncRNA),URS00008B7CE9_9606(lncRNA),URS00008B883D_9606(lncRNA),URS00008B9419_9606(lncRNA),URS00008B991F_9606(lncRNA),URS00008BB2ED_9606(lncRNA),URS00008BC666_9606(lncRNA),URS00008BCA3B_9606(lncRNA),URS00008BD472_9606(lncRNA),URS00008C0058_9606(lncRNA),URS00008C0A79_9606(lncRNA),URS00008C0D76_9606(lncRNA),URS00008C15F6_9606(lncRNA),URS00008C1BCE_9606(lncRNA),URS00008C2BF5_9606(lncRNA),URS00009AE664_9606(lncRNA),URS00009AE80F_9606(lncRNA),URS00009AEE8E_9606(lncRNA),URS00009B629F_9606(lncRNA),URS00009BA636_9606(lncRNA),URS00009BBB44_9606(lncRNA),URS00009BCE1D_9606(lncRNA),URS00009BED68_9606(lncRNA),URS00009C227F_9606(lncRNA),URS00009C4337_9606(lncRNA),URS00009C4AE5_9606(lncRNA),URS0000A80260_9606(lncRNA),URS0000CCDF7F_9606(lncRNA),URS0000CCDFCD_9606(lncRNA),URS0000CCDFEE_9606(lncRNA),URS0000CCE004_9606(lncRNA),URS0000CCE03F_9606(lncRNA),URS0000CCE053_9606(lncRNA),URS0000CCE07A_9606(lncRNA),URS0000CCE0B6_9606(lncRNA),URS0000CCE0C1_9606(lncRNA),URS0000CCE0C7_9606(lncRNA),URS0000CCE0E6_9606(lncRNA),URS0000CCE0FF_9606(lncRNA),URS0000CCE104_9606(lncRNA),URS0000CCE10E_9606(lncRNA),URS0000CCE12A_9606(lncRNA),URS0000D56DBC_9606(lncRNA),URS0000D574C4_9606(lncRNA),URS0000D57AAB_9606(lncRNA),URS0000D57C33_9606(lncRNA),URS0000D57C9D_9606(lncRNA),URS0000D58AD7_9606(lncRNA),URS0000D58B68_9606(lncRNA),URS0000D58CB2_9606(lncRNA),URS0000D58E93_9606(lncRNA),URS0000D5948E_9606(lncRNA),URS0000D59535_9606(lncRNA),URS0000D599CB_9606(lncRNA),URS0000D5A48C_9606(lncRNA),URS0000D5A608_9606(lncRNA),URS0000D5A702_9606(lncRNA),URS0000D5AA2B_9606(lncRNA),URS0000D5AB45_9606(lncRNA),URS0000D5B48A_9606(lncRNA),URS0000D5C34A_9606(lncRNA),URS0000D5C393_9606(lncRNA),URS0000D5C5C1_9606(lncRNA),URS0000D5C60C_9606(lncRNA),URS0000D5CE9A_9606(lncRNA),URS0000D5D155_9606(lncRNA),URS0000D5D3F7_9606(lncRNA),URS0000D5D74F_9606(lncRNA),URS0000D5DC38_9606(lncRNA),URS0000D5E306_9606(lncRNA),URS0000EA0F94_9606(lncRNA),URS0000EF4377_9606(lncRNA),URS00019BF8D5_9606(lncRNA),URS0001BC7968_9606(snoRNA),URS0001BCB772_9606(lncRNA),URS0001BCCF8B_9606(lncRNA),URS0001BCD56D_9606(lncRNA),URS0001BCD741_9606(lncRNA),URS0001BCF2DD_9606(lncRNA),URS0001BD044C_9606(lncRNA),URS0001BD1A51_9606(lncRNA),URS0001BD3771_9606(lncRNA),URS0001BD3FEF_9606(lncRNA),URS0001BD50F2_9606(lncRNA),URS0001BD549F_9606(lncRNA),URS0001BD6878_9606(lncRNA),URS0001BD6EFB_9606(lncRNA),URS0001BD8757_9606(lncRNA),URS0001BDAB6D_9606(lncRNA),URS0001BDBD5F_9606(lncRNA),URS0001BDC64F_9606(lncRNA),URS0001BE02C6_9606(lncRNA),URS0001BE0468_9606(lncRNA),URS0001BE169A_9606(lncRNA),URS0001BE1BF4_9606(lncRNA),URS0001BE2106_9606(lncRNA),URS0001BE22CC_9606(lncRNA),URS0001BE26FF_9606(lncRNA),URS0001BE30C4_9606(lncRNA),URS0001BE55B9_9606(lncRNA),URS0001BE6D3C_9606(lncRNA),URS0001BE9684_9606(lncRNA),URS0001BEA4A7_9606(lncRNA),URS0001BEA965_9606(lncRNA),URS0001BEB416_9606(lncRNA),URS0001BED74D_9606(lncRNA),URS0001BEE491_9606(lncRNA),URS0001BEFBA8_9606(lncRNA),URS0001BEFF33_9606(lncRNA),URS0001BF0144_9606(lncRNA),URS0001BF03AF_9606(lncRNA),URS0001BF107B_9606(lncRNA),URS0001BF2483_9606(lncRNA),URS0001BF28F7_9606(lncRNA),URS0001BF3832_9606(lncRNA),URS0001BF5440_9606(lncRNA),URS0001BF6A47_9606(lncRNA),URS0001BF738C_9606(lncRNA),URS0001BF8EC8_9606(lncRNA),URS0001BF9C77_9606(lncRNA),URS0001BF9F5D_9606(lncRNA),URS0001BFA1B0_9606(lncRNA),URS0001BFA420_9606(lncRNA),URS0001BFA68C_9606(lncRNA),URS00021FBAD5_9606(lncRNA),URS0002218A4A_9606(lncRNA),URS0002276C2D_9606(lncRNA),URS00022AE845_9606(lncRNA),URS00022AEE19_9606(lncRNA),URS00022AEEFE_9606(lncRNA),URS00022AF133_9606(lncRNA),URS00022B0225_9606(lncRNA),URS00022B0C15_9606(lncRNA),URS00022B137A_9606(lncRNA),URS00022B15AA_9606(lncRNA),URS00022B1858_9606(lncRNA),URS00022B1EF5_9606(lncRNA),URS00022B2095_9606(lncRNA),URS00022B21B2_9606(lncRNA),URS00022B2236_9606(lncRNA),URS00022B23C3_9606(lncRNA),URS00022B2A25_9606(lncRNA),URS00022B30ED_9606(lncRNA),URS00022B3120_9606(lncRNA),URS00022B3949_9606(lncRNA),URS00022B3A51_9606(lncRNA),URS00022B3D16_9606(lncRNA),URS00022B3D8A_9606(lncRNA),URS00022B3E09_9606(lncRNA),URS00022B3EF9_9606(lncRNA),URS00022B3FAD_9606(lncRNA),URS00022B45C4_9606(lncRNA),URS00022B461B_9606(lncRNA),URS00022B4821_9606(lncRNA),URS00022B4B51_9606(lncRNA),URS00022B575C_9606(lncRNA),URS00022B591C_9606(lncRNA),URS00022B5B49_9606(lncRNA),URS00022B5EC0_9606(lncRNA),URS00022B671C_9606(lncRNA),URS00022B74A0_9606(lncRNA),URS00022B7566_9606(lncRNA),URS00022B77FD_9606(lncRNA),URS00022B7A55_9606(lncRNA),URS00022B8675_9606(lncRNA),URS00022B8D24_9606(lncRNA),URS00022B8E31_9606(lncRNA),URS00022B8E3A_9606(lncRNA),URS00022B8FB5_9606(lncRNA),URS00022B8FC7_9606(lncRNA),URS00022B9426_9606(lncRNA),URS00022B9481_9606(lncRNA),URS00022B962E_9606(lncRNA)	A	SM-ONLY
chrX	136879222	136879273	-	480	480	0	RBMX(protein_coding),SNORD61(snoRNA),URS0000313FF1_9606(snoRNA),URS0000D6E522_9606(lncRNA),URS0000EA22A8_9606(lncRNA),URS0001BC766D_9606(snoRNA)	A	SM-PC
chr11	93733247	93733299	-	388	388	0	SNORD5(snoRNA),TAF1D(protein_coding),URS00001B6381_9606(snoRNA),URS000044B166_9606(piRNA),URS0000694F71_9606(snoRNA),URS00008B44CA_9606(lncRNA),URS00008B52AF_9606(lncRNA),URS00008B875B_9606(lncRNA),URS00008BB796_9606(lncRNA),URS00008BBE72_9606(lncRNA),URS00008BEBE5_9606(lncRNA),URS00008BF46D_9606(lncRNA),URS00008C015E_9606(lncRNA),URS0000EC1F16_9606(lncRNA),URS0001BBF5A4_9606(ncRNA)	A	SM-PC
chr19	10109761	10109834	+	348	348	0	SNORD105B(snoRNA),URS000064B8EB_9606(snoRNA),URS000075DF1C_9606(snoRNA),URS0001BC5C73_9606(snoRNA)	A	SM-ONLY
chr20	2462961	2463036	-	341	341	0	URS000075EC44_9606(snoRNA),URS000081F58C_9606(snoRNA)	A	SM-ONLY
chr3	52692742	52692809	+	289	289	0	SNORD69(snoRNA),URS00006292A1_9606(snoRNA),URS0000EC21A0_9606(lncRNA),URS0001BC5E6C_9606(snoRNA)	A	SM-ONLY
chr11	62855031	62855083	-	288	288	0	SNHG1(lncRNA),SNORD27(snoRNA),URS000041615F_9606(snoRNA),URS00005F4016_9606(misc_RNA),URS00008C0C32_9606(lncRNA),URS00008C0CC6_9606(lncRNA),URS00008C1085_9606(lncRNA),URS00008C12CA_9606(lncRNA),URS00008C1464_9606(lncRNA),URS00008C1508_9606(lncRNA),URS00008C167B_9606(lncRNA),URS00008C191F_9606(lncRNA),URS00008C1A56_9606(lncRNA),URS00008C1CD0_9606(lncRNA),URS00008C1D08_9606(lncRNA),URS00008C2147_9606(lncRNA),URS00008C22A8_9606(lncRNA),URS00008C22F5_9606(lncRNA),URS00008C2432_9606(lncRNA),URS00008C24BC_9606(lncRNA),URS00008C2EDC_9606(lncRNA),URS00008C355C_9606(lncRNA),URS00008C392D_9606(lncRNA),URS00008C3AA7_9606(lncRNA),URS00008C3E49_9606(lncRNA),URS00008C409D_9606(lncRNA),URS00009B63CD_9606(lncRNA),URS00009B9E39_9606(lncRNA),URS00009BAB70_9606(lncRNA),URS00009BB13E_9606(lncRNA),URS00009BC8FE_9606(lncRNA),URS00009BF63C_9606(lncRNA),URS0000CCDF81_9606(lncRNA),URS0000CCDFCF_9606(lncRNA),URS0000CCDFDF_9606(lncRNA),URS0000CCE06F_9606(lncRNA),URS0000CCE076_9606(lncRNA),URS0000CCE0AB_9606(lncRNA),URS0000CCE0B4_9606(lncRNA),URS0000CCE0BC_9606(lncRNA),URS0000CCE0E1_9606(lncRNA),URS0000CCE108_9606(lncRNA),URS0000CCE128_9606(lncRNA),URS0000CCE14E_9606(lncRNA),URS0000D57192_9606(lncRNA),URS0000D5722B_9606(lncRNA),URS0000D577F5_9606(lncRNA),URS0000D57F9D_9606(lncRNA),URS0000D583DF_9606(lncRNA),URS0000D5874A_9606(lncRNA),URS0000D58A95_9606(lncRNA),URS0000D58D79_9606(lncRNA),URS0000D58E2D_9606(lncRNA),URS0000D58F0C_9606(lncRNA),URS0000D58F7B_9606(lncRNA),URS0000D5976C_9606(lncRNA),URS0000D5A047_9606(lncRNA),URS0000D5A3CA_9606(lncRNA),URS0000D5A664_9606(lncRNA),URS0000D5ACC0_9606(lncRNA),URS0000D5AE9B_9606(lncRNA),URS0000D5B306_9606(lncRNA),URS0000D5B526_9606(lncRNA),URS0000D5B874_9606(lncRNA),URS0000D5C0E1_9606(lncRNA),URS0000D5C4AC_9606(lncRNA),URS0000D5C936_9606(lncRNA),URS0000D5C999_9606(lncRNA),URS0000D5CA9E_9606(lncRNA),URS0000D5CE46_9606(lncRNA),URS0000D5D344_9606(lncRNA),URS0000D5D697_9606(lncRNA),URS0000D5DB22_9606(lncRNA),URS0000D5DF6D_9606(lncRNA),URS0000D5E3D8_9606(lncRNA),URS0000EEAEF8_9606(lncRNA),URS0000EEB6FE_9606(lncRNA),URS0000EEC386_9606(lncRNA),URS0000EEC677_9606(lncRNA),URS0000EEC7F2_9606(lncRNA),URS0000EECE76_9606(lncRNA),URS0000EEE090_9606(lncRNA),URS0000EEEED6_9606(lncRNA),URS0000EEF08F_9606(lncRNA),URS0000EEF2B0_9606(lncRNA),URS0000EEFB92_9606(lncRNA),URS0000EEFF3B_9606(lncRNA),URS0000EEFF46_9606(lncRNA),URS0000EF0DB0_9606(lncRNA),URS0000EF120E_9606(lncRNA),URS0000EF123A_9606(lncRNA),URS0000EF1858_9606(lncRNA),URS0000EF21B0_9606(lncRNA),URS0000EF2DFF_9606(lncRNA),URS0000EF301C_9606(lncRNA),URS0000EF3572_9606(lncRNA),URS0000EF37E8_9606(lncRNA),URS0000EF3A9F_9606(lncRNA),URS0000EF3CF1_9606(lncRNA),URS0000EF3DF9_9606(lncRNA),URS0000EF3F1E_9606(lncRNA),URS0000EF4F8E_9606(lncRNA),URS0000EF5E17_9606(lncRNA),URS0000EF6AE6_9606(lncRNA),URS0000EF6DD5_9606(lncRNA),URS00019EB4E2_9606(lncRNA),URS0001BBFB93_9606(snoRNA),URS0001BCAB26_9606(lncRNA),URS0001BCB0B6_9606(lncRNA),URS0001BCCC88_9606(lncRNA),URS0001BCD596_9606(lncRNA),URS0001BD06A8_9606(lncRNA),URS0001BD52E5_9606(lncRNA),URS0001BD6BA6_9606(lncRNA),URS0001BD6FE6_9606(snoRNA),URS0001BD846E_9606(lncRNA),URS0001BD9C2E_9606(lncRNA),URS0001BDD58E_9606(lncRNA),URS0001BDF7F4_9606(lncRNA),URS0001BDFE60_9606(lncRNA),URS0001BE1ECE_9606(lncRNA),URS0001BE5B4C_9606(lncRNA),URS0001BE719F_9606(lncRNA),URS0001BE7311_9606(lncRNA),URS0001BE75DE_9606(lncRNA),URS0001BE9A8D_9606(lncRNA),URS0001BEA6C7_9606(lncRNA),URS0001BEE0F5_9606(lncRNA),URS0001BEFAFF_9606(lncRNA),URS0001BF0F3B_9606(lncRNA),URS0001BF2ABE_9606(lncRNA),URS0001BF32E6_9606(lncRNA),URS0001BF7152_9606(lncRNA),URS0001BF78F6_9606(lncRNA),URS0001BF8051_9606(lncRNA),URS0001BF8847_9606(lncRNA),URS0001BF88A5_9606(lncRNA),URS0001BF918D_9606(lncRNA),URS0001BF9715_9606(lncRNA),URS0001BF9F44_9606(lncRNA),URS0001C778E7_9606(lncRNA),URS0001E80857_9606(lncRNA),URS000224B7D5_9606(lncRNA),URS0002262841_9606(lncRNA),URS000226E769_9606(lncRNA),URS00022AF335_9606(lncRNA),URS00022AF3D3_9606(lncRNA),URS00022AF716_9606(lncRNA),URS00022AF98F_9606(lncRNA),URS00022AFC46_9606(lncRNA),URS00022B0198_9606(lncRNA),URS00022B0581_9606(lncRNA),URS00022B0956_9606(lncRNA),URS00022B0C17_9606(lncRNA),URS00022B14A8_9606(lncRNA),URS00022B2175_9606(lncRNA),URS00022B3507_9606(lncRNA),URS00022B437F_9606(lncRNA),URS00022B6E99_9606(lncRNA),URS00022B7711_9606(lncRNA),URS00022B781F_9606(lncRNA),URS00022B7FCB_9606(lncRNA),URS00022B81C8_9606(lncRNA),URS00022B81D1_9606(lncRNA),URS00022B82C5_9606(lncRNA),URS00022B87F3_9606(lncRNA),URS00022B87F5_9606(lncRNA),URS00022B8E00_9606(lncRNA)	A	SM-ONLY
chr16	46886418	46886472	+	288	288	0	NA	U	Novel
chr15	66503240	66503314	-	287	287	0	RPL4(protein_coding),SNORD18A(snoRNA),URS00004DF250_9606(snoRNA),URS0000651CAB_9606(snoRNA),URS0000D6E1E8_9606(lncRNA),URS0000D6E75E_9606(lncRNA),URS0001BBF378_9606(snoRNA)	A	SM-PC
chr20	2656937	2656992	+	277	277	0	NOP56(protein_coding),SNORD57(snoRNA),URS000006F34F_9606(piRNA),URS00002AEC84_9606(piRNA),URS00002D5839_9606(piRNA),URS00003C164B_9606(piRNA),URS0000406CED_9606(snoRNA),URS00004DDBAC_9606(piRNA),URS0000E15B0E_9606(lncRNA),URS0000E9622D_9606(lncRNA),URS0000EA6C03_9606(lncRNA),URS0000EB5A4C_9606(lncRNA),URS0001BC08BE_9606(snoRNA)	A	SM-PC
chr17	16440035	16440087	+	265	265	0	SNHG29(lncRNA),SNORD49A(snoRNA),URS00003B08B2_9606(snoRNA),URS0000508296_9606(piRNA),URS000075992B_9606(lncRNA),URS0000759A29_9606(lncRNA),URS000075A2C0_9606(lncRNA),URS000075A366_9606(lncRNA),URS000075A6C5_9606(lncRNA),URS000075A7AE_9606(lncRNA),URS000075A7D4_9606(lncRNA),URS000075AA37_9606(lncRNA),URS000075AE43_9606(lncRNA),URS000075AE9D_9606(lncRNA),URS000075BC33_9606(lncRNA),URS000075BFEA_9606(lncRNA),URS000075C121_9606(lncRNA),URS000075C1E5_9606(lncRNA),URS000075C273_9606(lncRNA),URS000075C465_9606(lncRNA),URS000075C789_9606(lncRNA),URS000075CC86_9606(lncRNA),URS000075CD39_9606(lncRNA),URS000075CD68_9606(lncRNA),URS000075CD85_9606(lncRNA),URS000075CDD3_9606(lncRNA),URS000075D276_9606(lncRNA),URS000075D7B9_9606(lncRNA),URS000075DF3E_9606(lncRNA),URS000075E65C_9606(lncRNA),URS000075E97C_9606(lncRNA),URS000075E980_9606(lncRNA),URS000075EB32_9606(lncRNA),URS000075EB6C_9606(lncRNA),URS000075EF93_9606(lncRNA),URS000075EFBA_9606(lncRNA),URS00009AD252_9606(lncRNA),URS00009AD4B2_9606(lncRNA),URS00009AE3D8_9606(lncRNA),URS00009AE8B9_9606(lncRNA),URS00009AEA42_9606(lncRNA),URS00009AEDBA_9606(lncRNA),URS00009AF812_9606(lncRNA),URS00009AF8F7_9606(lncRNA),URS00009B194C_9606(lncRNA),URS00009B1F4B_9606(lncRNA),URS00009B2FA1_9606(lncRNA),URS00009B3929_9606(lncRNA),URS00009B3F63_9606(lncRNA),URS00009B3FFD_9606(lncRNA),URS00009B56A4_9606(lncRNA),URS00009B5F97_9606(lncRNA),URS00009B717E_9606(lncRNA),URS00009B744B_9606(lncRNA),URS00009B87D1_9606(lncRNA),URS00009B8847_9606(lncRNA),URS00009B88CC_9606(lncRNA),URS00009B9C37_9606(lncRNA),URS00009B9D43_9606(lncRNA),URS00009BB2A5_9606(lncRNA),URS00009BB7BE_9606(lncRNA),URS00009BD4AC_9606(lncRNA),URS00009BD84B_9606(lncRNA),URS00009BDAFB_9606(lncRNA),URS00009BDE33_9606(lncRNA),URS00009BE037_9606(lncRNA),URS00009BF5B4_9606(lncRNA),URS00009BF602_9606(lncRNA),URS00009BFAE5_9606(lncRNA),URS00009C0CD0_9606(lncRNA),URS00009C1670_9606(lncRNA),URS00009C2B3A_9606(lncRNA),URS00009C3024_9606(lncRNA),URS00009C368D_9606(lncRNA),URS00009C5136_9606(lncRNA),URS00009C53A9_9606(lncRNA),URS00009C553A_9606(lncRNA),URS0000A7AE13_9606(lncRNA),URS0000A7C473_9606(lncRNA),URS0000A7EF6B_9606(lncRNA),URS0000A7FF18_9606(lncRNA),URS0000A80BF3_9606(lncRNA),URS0000A87CEC_9606(lncRNA),URS0000A8A1ED_9606(lncRNA),URS0000A8E72C_9606(lncRNA),URS0000A90555_9606(lncRNA),URS0000A9116B_9606(lncRNA),URS0000A9C7D0_9606(lncRNA),URS0000A9FD66_9606(lncRNA),URS0000AA17A5_9606(lncRNA),URS0000AA5C17_9606(lncRNA),URS0000AA6DF0_9606(lncRNA),URS0000AA76A0_9606(lncRNA),URS0000AA94C3_9606(lncRNA),URS0000AAAA45_9606(lncRNA),URS0000AAE978_9606(lncRNA),URS0000D58294_9606(lncRNA),URS0000D59E4B_9606(lncRNA),URS0000D59EF5_9606(lncRNA),URS0000D5A138_9606(lncRNA),URS0000D5A356_9606(lncRNA),URS0000D5D2EA_9606(lncRNA),URS0000EACC24_9606(lncRNA),URS0000EEB279_9606(lncRNA),URS0000EEB2B3_9606(lncRNA),URS0000EEB3DC_9606(lncRNA),URS0000EEBC40_9606(lncRNA),URS0000EEE0ED_9606(lncRNA),URS0000EEF0A7_9606(lncRNA),URS0000EEF1C7_9606(lncRNA),URS0000EEFA58_9606(lncRNA),URS0000EEFF66_9606(lncRNA),URS0000EF0287_9606(lncRNA),URS0000EF063A_9606(lncRNA),URS0000EF0655_9606(lncRNA),URS0000EF084F_9606(lncRNA),URS0000EF0ABF_9606(lncRNA),URS0000EF11CF_9606(lncRNA),URS0000EF1319_9606(lncRNA),URS0000EF2541_9606(lncRNA),URS0000EF2697_9606(lncRNA),URS0000EF27CE_9606(lncRNA),URS0000EF28AC_9606(lncRNA),URS0000EF2F79_9606(lncRNA),URS0000EF3757_9606(lncRNA),URS0000EF3B27_9606(lncRNA),URS0000EF3BDA_9606(lncRNA),URS0000EF3C23_9606(lncRNA),URS0000EF3EF1_9606(lncRNA),URS0000EF50B5_9606(lncRNA),URS0000EF59E1_9606(lncRNA),URS0000EF619B_9606(lncRNA),URS0000EF61CE_9606(lncRNA),URS0000EF6A8E_9606(lncRNA),URS0001BCA20D_9606(snoRNA),URS0001BCBA6E_9606(lncRNA),URS0001BCD003_9606(lncRNA),URS0001BCD89B_9606(lncRNA),URS0001BCDD44_9606(lncRNA),URS0001BCE27B_9606(lncRNA),URS0001BCE2E8_9606(lncRNA),URS0001BCEA2F_9606(lncRNA),URS0001BCF7B7_9606(lncRNA),URS0001BCF87A_9606(lncRNA),URS0001BD065A_9606(lncRNA),URS0001BD11CC_9606(lncRNA),URS0001BD2BD3_9606(lncRNA),URS0001BD345F_9606(lncRNA),URS0001BD547C_9606(lncRNA),URS0001BD567C_9606(lncRNA),URS0001BD7917_9606(lncRNA),URS0001BD7BC5_9606(lncRNA),URS0001BD8299_9606(lncRNA),URS0001BD88AF_9606(lncRNA),URS0001BD9E51_9606(lncRNA),URS0001BDC1B9_9606(lncRNA),URS0001BDCA58_9606(lncRNA),URS0001BDEC50_9606(lncRNA),URS0001BDF7A4_9606(lncRNA),URS0001BDFAF1_9606(lncRNA),URS0001BDFF7E_9606(lncRNA),URS0001BE03F3_9606(lncRNA),URS0001BE28B3_9606(lncRNA),URS0001BE3640_9606(lncRNA),URS0001BE3B59_9606(lncRNA),URS0001BE4282_9606(lncRNA),URS0001BE568F_9606(lncRNA),URS0001BE6111_9606(lncRNA),URS0001BE7A15_9606(lncRNA),URS0001BE82B4_9606(lncRNA),URS0001BEBB50_9606(lncRNA),URS0001BECA85_9606(lncRNA),URS0001BF0E46_9606(lncRNA),URS0001BF34F2_9606(lncRNA),URS0001BF51E8_9606(lncRNA),URS0001BF572A_9606(lncRNA),URS0001BF5F14_9606(lncRNA),URS0001BF6529_9606(lncRNA),URS0001BFA3AE_9606(lncRNA),URS0001F0ED11_9606(lncRNA),URS0001FE5747_9606(lncRNA),URS0002208D5B_9606(lncRNA),URS0002208EDF_9606(lncRNA),URS0002216F35_9606(lncRNA),URS000221A6A0_9606(lncRNA),URS000223FE99_9606(lncRNA),URS0002260337_9606(lncRNA),URS000226770B_9606(lncRNA),URS00022781C2_9606(lncRNA),URS00022B027D_9606(lncRNA),URS00022B07C8_9606(lncRNA),URS00022B1A2C_9606(lncRNA),URS00022B3FCA_9606(lncRNA),URS00022B4176_9606(lncRNA),URS00022B5375_9606(lncRNA),URS00022B5526_9606(lncRNA),URS00022B5F90_9606(lncRNA),URS00022B6104_9606(lncRNA),URS00022B670C_9606(lncRNA),URS00022B6AB7_9606(lncRNA),URS00022B6F27_9606(lncRNA),URS00022B7451_9606(lncRNA),URS00022B760E_9606(lncRNA),URS00022B8D89_9606(lncRNA)	A	SM-ONLY
chr11	62853322	62853393	-	255	255	0	SNHG1(lncRNA),URS0000130A5F_9606(snoRNA),URS00001D24B1_9606(misc_RNA),URS00005F4016_9606(misc_RNA),URS000066CF48_9606(snoRNA),URS00008B57DA_9606(lncRNA),URS00008C0C32_9606(lncRNA),URS00008C0CC6_9606(lncRNA),URS00008C1085_9606(lncRNA),URS00008C1D08_9606(lncRNA),URS00008C2147_9606(lncRNA),URS00008C22A8_9606(lncRNA),URS00008C22F5_9606(lncRNA),URS00008C2432_9606(lncRNA),URS00008C24BC_9606(lncRNA),URS00008C2EDC_9606(lncRNA),URS00008C3031_9606(lncRNA),URS00008C355C_9606(lncRNA),URS00008C392D_9606(lncRNA),URS00008C3AA7_9606(lncRNA),URS00008C3E49_9606(lncRNA),URS00008C409D_9606(lncRNA),URS00009B63CD_9606(lncRNA),URS00009B9E39_9606(lncRNA),URS00009BAB70_9606(lncRNA),URS00009BB13E_9606(lncRNA),URS00009BC8FE_9606(lncRNA),URS00009BEBF4_9606(lncRNA),URS00009BF63C_9606(lncRNA),URS0000CCDF81_9606(lncRNA),URS0000CCDFCF_9606(lncRNA),URS0000CCDFDF_9606(lncRNA),URS0000CCE06F_9606(lncRNA),URS0000CCE076_9606(lncRNA),URS0000CCE0AB_9606(lncRNA),URS0000CCE0B4_9606(lncRNA),URS0000CCE0BC_9606(lncRNA),URS0000CCE0E1_9606(lncRNA),URS0000CCE108_9606(lncRNA),URS0000CCE128_9606(lncRNA),URS0000CCE14E_9606(lncRNA),URS0000D57192_9606(lncRNA),URS0000D5722B_9606(lncRNA),URS0000D57F9D_9606(lncRNA),URS0000D583DF_9606(lncRNA),URS0000D5874A_9606(lncRNA),URS0000D58A95_9606(lncRNA),URS0000D58D79_9606(lncRNA),URS0000D58E2D_9606(lncRNA),URS0000D58F0C_9606(lncRNA),URS0000D5976C_9606(lncRNA),URS0000D5A047_9606(lncRNA),URS0000D5A3CA_9606(lncRNA),URS0000D5A664_9606(lncRNA),URS0000D5A7A2_9606(lncRNA),URS0000D5AE9B_9606(lncRNA),URS0000D5BC0C_9606(lncRNA),URS0000D5C0E1_9606(lncRNA),URS0000D5C4AC_9606(lncRNA),URS0000D5C936_9606(lncRNA),URS0000D5C999_9606(lncRNA),URS0000D5CA9E_9606(lncRNA),URS0000D5CC94_9606(lncRNA),URS0000D5CE46_9606(lncRNA),URS0000D5D344_9606(lncRNA),URS0000D5DB22_9606(lncRNA),URS0000D5DF6D_9606(lncRNA),URS0000D5E3D8_9606(lncRNA),URS0000EEAEF8_9606(lncRNA),URS0000EEB6FE_9606(lncRNA),URS0000EEC386_9606(lncRNA),URS0000EEC677_9606(lncRNA),URS0000EEC7F2_9606(lncRNA),URS0000EECE76_9606(lncRNA),URS0000EEE090_9606(lncRNA),URS0000EEEED6_9606(lncRNA),URS0000EEF08F_9606(lncRNA),URS0000EEF2B0_9606(lncRNA),URS0000EEFB92_9606(lncRNA),URS0000EEFF3B_9606(lncRNA),URS0000EEFF46_9606(lncRNA),URS0000EF0DB0_9606(lncRNA),URS0000EF120E_9606(lncRNA),URS0000EF123A_9606(lncRNA),URS0000EF1858_9606(lncRNA),URS0000EF21B0_9606(lncRNA),URS0000EF2DFF_9606(lncRNA),URS0000EF301C_9606(lncRNA),URS0000EF3572_9606(lncRNA),URS0000EF37E8_9606(lncRNA),URS0000EF3A9F_9606(lncRNA),URS0000EF3CF1_9606(lncRNA),URS0000EF3DF9_9606(lncRNA),URS0000EF3F1E_9606(lncRNA),URS0000EF4F8E_9606(lncRNA),URS0000EF5E17_9606(lncRNA),URS0000EF6AE6_9606(lncRNA),URS0000EF6DD5_9606(lncRNA),URS00019EB4E2_9606(lncRNA),URS0001BBF00E_9606(snoRNA),URS0001BCAB26_9606(lncRNA),URS0001BCB0B6_9606(lncRNA),URS0001BCCC88_9606(lncRNA),URS0001BCD596_9606(lncRNA),URS0001BD52E5_9606(lncRNA),URS0001BD61A6_9606(lncRNA),URS0001BD6BA6_9606(lncRNA),URS0001BD6FE6_9606(snoRNA),URS0001BD846E_9606(lncRNA),URS0001BD9C2E_9606(lncRNA),URS0001BDD58E_9606(lncRNA),URS0001BDF7F4_9606(lncRNA),URS0001BDFE60_9606(lncRNA),URS0001BE1ECE_9606(lncRNA),URS0001BE2C73_9606(lncRNA),URS0001BE5B4C_9606(lncRNA),URS0001BE719F_9606(lncRNA),URS0001BE7311_9606(lncRNA),URS0001BE75DE_9606(lncRNA),URS0001BE9A8D_9606(lncRNA),URS0001BEA6C7_9606(lncRNA),URS0001BEE0F5_9606(lncRNA),URS0001BEE583_9606(lncRNA),URS0001BEFAFF_9606(lncRNA),URS0001BF0F3B_9606(lncRNA),URS0001BF2ABE_9606(lncRNA),URS0001BF7152_9606(lncRNA),URS0001BF78F6_9606(lncRNA),URS0001BF8051_9606(lncRNA),URS0001BF8847_9606(lncRNA),URS0001BF918D_9606(lncRNA),URS0001BF9715_9606(lncRNA),URS0001BF9F44_9606(lncRNA),URS0001C778E7_9606(lncRNA),URS0001E80857_9606(lncRNA),URS000224B7D5_9606(lncRNA),URS0002262841_9606(lncRNA),URS000226E769_9606(lncRNA),URS00022AF335_9606(lncRNA),URS00022AF3D3_9606(lncRNA),URS00022AF716_9606(lncRNA),URS00022AF98F_9606(lncRNA),URS00022AFC46_9606(lncRNA),URS00022B0198_9606(lncRNA),URS00022B0581_9606(lncRNA),URS00022B0956_9606(lncRNA),URS00022B0C17_9606(lncRNA),URS00022B14A8_9606(lncRNA),URS00022B2175_9606(lncRNA),URS00022B3507_9606(lncRNA),URS00022B437F_9606(lncRNA),URS00022B6E99_9606(lncRNA),URS00022B7711_9606(lncRNA),URS00022B781F_9606(lncRNA),URS00022B7FCB_9606(lncRNA),URS00022B81C8_9606(lncRNA),URS00022B81D1_9606(lncRNA),URS00022B82C5_9606(lncRNA),URS00022B87F3_9606(lncRNA),URS00022B87F5_9606(lncRNA),URS00022B8E00_9606(lncRNA)	A	SM-ONLY
chr1	173864853	173864905	-	252	252	0	GAS5(lncRNA),URS000026795D_9606(snoRNA),URS000050BD61_9606(snoRNA),URS000072E51D_9606(snoRNA),URS000072F791_9606(snoRNA),URS0000832FA3_9606(snoRNA),URS00008B3431_9606(lncRNA),URS00008B3C85_9606(lncRNA),URS00008B41F4_9606(lncRNA),URS00008B4DAD_9606(lncRNA),URS00008B4E64_9606(lncRNA),URS00008B6DB9_9606(lncRNA),URS00008B7CE9_9606(lncRNA),URS00008B883D_9606(lncRNA),URS00008B9419_9606(lncRNA),URS00008B991F_9606(lncRNA),URS00008BB2ED_9606(lncRNA),URS00008BC666_9606(lncRNA),URS00008BCA3B_9606(lncRNA),URS00008BD472_9606(lncRNA),URS00008C0058_9606(lncRNA),URS00008C0A79_9606(lncRNA),URS00008C0D76_9606(lncRNA),URS00008C15F6_9606(lncRNA),URS00008C1BCE_9606(lncRNA),URS00008C2BF5_9606(lncRNA),URS00008C3A01_9606(lncRNA),URS00009AE664_9606(lncRNA),URS00009AE80F_9606(lncRNA),URS00009AEE8E_9606(lncRNA),URS00009B629F_9606(lncRNA),URS00009BA636_9606(lncRNA),URS00009BBB44_9606(lncRNA),URS00009BCE1D_9606(lncRNA),URS00009BED68_9606(lncRNA),URS00009C227F_9606(lncRNA),URS00009C4337_9606(lncRNA),URS00009C4AE5_9606(lncRNA),URS0000A80260_9606(lncRNA),URS0000CCDF7F_9606(lncRNA),URS0000CCDFCD_9606(lncRNA),URS0000CCDFEE_9606(lncRNA),URS0000CCE004_9606(lncRNA),URS0000CCE03F_9606(lncRNA),URS0000CCE053_9606(lncRNA),URS0000CCE07A_9606(lncRNA),URS0000CCE0B6_9606(lncRNA),URS0000CCE0C1_9606(lncRNA),URS0000CCE0C7_9606(lncRNA),URS0000CCE0E6_9606(lncRNA),URS0000CCE0FF_9606(lncRNA),URS0000CCE104_9606(lncRNA),URS0000CCE10E_9606(lncRNA),URS0000CCE12A_9606(lncRNA),URS0000D56DBC_9606(lncRNA),URS0000D574C4_9606(lncRNA),URS0000D57AAB_9606(lncRNA),URS0000D57C33_9606(lncRNA),URS0000D57C9D_9606(lncRNA),URS0000D58AD7_9606(lncRNA),URS0000D58B68_9606(lncRNA),URS0000D58CB2_9606(lncRNA),URS0000D58E93_9606(lncRNA),URS0000D5948E_9606(lncRNA),URS0000D59535_9606(lncRNA),URS0000D599CB_9606(lncRNA),URS0000D5A48C_9606(lncRNA),URS0000D5A608_9606(lncRNA),URS0000D5A702_9606(lncRNA),URS0000D5AA2B_9606(lncRNA),URS0000D5AB45_9606(lncRNA),URS0000D5B48A_9606(lncRNA),URS0000D5C34A_9606(lncRNA),URS0000D5C393_9606(lncRNA),URS0000D5C5C1_9606(lncRNA),URS0000D5C60C_9606(lncRNA),URS0000D5C735_9606(lncRNA),URS0000D5C88D_9606(lncRNA),URS0000D5CE9A_9606(lncRNA),URS0000D5D155_9606(lncRNA),URS0000D5D3F7_9606(lncRNA),URS0000D5D74F_9606(lncRNA),URS0000D5DB9C_9606(lncRNA),URS0000D5DC38_9606(lncRNA),URS0000D5E306_9606(lncRNA),URS0000EA0F94_9606(lncRNA),URS0000EF4377_9606(lncRNA),URS00019BF8D5_9606(lncRNA),URS0001BBFBB2_9606(snoRNA),URS0001BCB772_9606(lncRNA),URS0001BCCF8B_9606(lncRNA),URS0001BCD56D_9606(lncRNA),URS0001BCD741_9606(lncRNA),URS0001BCE45E_9606(lncRNA),URS0001BCF2DD_9606(lncRNA),URS0001BD044C_9606(lncRNA),URS0001BD1A51_9606(lncRNA),URS0001BD3771_9606(lncRNA),URS0001BD3FEF_9606(lncRNA),URS0001BD50F2_9606(lncRNA),URS0001BD549F_9606(lncRNA),URS0001BD6878_9606(lncRNA),URS0001BD6EFB_9606(lncRNA),URS0001BD8757_9606(lncRNA),URS0001BDAB6D_9606(lncRNA),URS0001BDBD5F_9606(lncRNA),URS0001BDC64F_9606(lncRNA),URS0001BE02C6_9606(lncRNA),URS0001BE0468_9606(lncRNA),URS0001BE169A_9606(lncRNA),URS0001BE1BF4_9606(lncRNA),URS0001BE2106_9606(lncRNA),URS0001BE22CC_9606(lncRNA),URS0001BE26FF_9606(lncRNA),URS0001BE30C4_9606(lncRNA),URS0001BE55B9_9606(lncRNA),URS0001BE6D3C_9606(lncRNA),URS0001BE9684_9606(lncRNA),URS0001BEA4A7_9606(lncRNA),URS0001BEA965_9606(lncRNA),URS0001BEB416_9606(lncRNA),URS0001BED74D_9606(lncRNA),URS0001BEE491_9606(lncRNA),URS0001BEFBA2_9606(lncRNA),URS0001BEFBA8_9606(lncRNA),URS0001BEFF33_9606(lncRNA),URS0001BF0144_9606(lncRNA),URS0001BF03AF_9606(lncRNA),URS0001BF107B_9606(lncRNA),URS0001BF2483_9606(lncRNA),URS0001BF28F7_9606(lncRNA),URS0001BF3832_9606(lncRNA),URS0001BF5440_9606(lncRNA),URS0001BF6A47_9606(lncRNA),URS0001BF738C_9606(lncRNA),URS0001BF8EC8_9606(lncRNA),URS0001BF9C77_9606(lncRNA),URS0001BF9F5D_9606(lncRNA),URS0001BFA1B0_9606(lncRNA),URS0001BFA420_9606(lncRNA),URS0001BFA68C_9606(lncRNA),URS00021FBAD5_9606(lncRNA),URS0002218A4A_9606(lncRNA),URS0002276C2D_9606(lncRNA),URS00022AE845_9606(lncRNA),URS00022AEE19_9606(lncRNA),URS00022AEEFE_9606(lncRNA),URS00022AF133_9606(lncRNA),URS00022B0225_9606(lncRNA),URS00022B0C15_9606(lncRNA),URS00022B137A_9606(lncRNA),URS00022B15AA_9606(lncRNA),URS00022B1858_9606(lncRNA),URS00022B1EF5_9606(lncRNA),URS00022B2095_9606(lncRNA),URS00022B21B2_9606(lncRNA),URS00022B2236_9606(lncRNA),URS00022B23C3_9606(lncRNA),URS00022B2A25_9606(lncRNA),URS00022B30ED_9606(lncRNA),URS00022B3120_9606(lncRNA),URS00022B3949_9606(lncRNA),URS00022B3A51_9606(lncRNA),URS00022B3D16_9606(lncRNA),URS00022B3D8A_9606(lncRNA),URS00022B3E09_9606(lncRNA),URS00022B3EF9_9606(lncRNA),URS00022B3FAD_9606(lncRNA),URS00022B45C4_9606(lncRNA),URS00022B461B_9606(lncRNA),URS00022B4821_9606(lncRNA),URS00022B4B51_9606(lncRNA),URS00022B575C_9606(lncRNA),URS00022B591C_9606(lncRNA),URS00022B5B49_9606(lncRNA),URS00022B5EC0_9606(lncRNA),URS00022B671C_9606(lncRNA),URS00022B74A0_9606(lncRNA),URS00022B7566_9606(lncRNA),URS00022B77FD_9606(lncRNA),URS00022B7A55_9606(lncRNA),URS00022B8675_9606(lncRNA),URS00022B8D24_9606(lncRNA),URS00022B8E31_9606(lncRNA),URS00022B8E3A_9606(lncRNA),URS00022B8FB5_9606(lncRNA),URS00022B8FC7_9606(lncRNA),URS00022B9426_9606(lncRNA),URS00022B9481_9606(lncRNA),URS00022B962E_9606(lncRNA)	A	SM-ONLY
chr11	62855580	62855632	-	234	234	0	SNHG1(lncRNA),SNORD25(snoRNA),URS0000454FD5_9606(snoRNA),URS00005F4016_9606(misc_RNA),URS00006B61AB_9606(snoRNA),URS00008C0C32_9606(lncRNA),URS00008C12CA_9606(lncRNA),URS00008C1CD0_9606(lncRNA),URS00008C2147_9606(lncRNA),URS00008C22F5_9606(lncRNA),URS00008C24BC_9606(lncRNA),URS00008C2EDC_9606(lncRNA),URS00009B9E39_9606(lncRNA),URS00009BB13E_9606(lncRNA),URS00009BC8FE_9606(lncRNA),URS0000CCDF81_9606(lncRNA),URS0000CCDFCF_9606(lncRNA),URS0000CCDFDF_9606(lncRNA),URS0000CCE06F_9606(lncRNA),URS0000CCE076_9606(lncRNA),URS0000CCE0AB_9606(lncRNA),URS0000CCE0B4_9606(lncRNA),URS0000CCE0BC_9606(lncRNA),URS0000CCE0E1_9606(lncRNA),URS0000CCE108_9606(lncRNA),URS0000CCE128_9606(lncRNA),URS0000CCE14E_9606(lncRNA),URS0000D570AD_9606(lncRNA),URS0000D57192_9606(lncRNA),URS0000D5722B_9606(lncRNA),URS0000D58A95_9606(lncRNA),URS0000D58D79_9606(lncRNA),URS0000D58E2D_9606(lncRNA),URS0000D58F7B_9606(lncRNA),URS0000D5976C_9606(lncRNA),URS0000D5ACC0_9606(lncRNA),URS0000D5C0E1_9606(lncRNA),URS0000D5C4AC_9606(lncRNA),URS0000D5CA9E_9606(lncRNA),URS0000D5CE46_9606(lncRNA),URS0000D5D344_9606(lncRNA),URS0000D5DB22_9606(lncRNA),URS0000D5E3D8_9606(lncRNA),URS0000EEAEF8_9606(lncRNA),URS0000EEB6FE_9606(lncRNA),URS0000EEC386_9606(lncRNA),URS0000EEC677_9606(lncRNA),URS0000EEC7F2_9606(lncRNA),URS0000EECE76_9606(lncRNA),URS0000EEE090_9606(lncRNA),URS0000EEEED6_9606(lncRNA),URS0000EEF08F_9606(lncRNA),URS0000EEF2B0_9606(lncRNA),URS0000EEFB92_9606(lncRNA),URS0000EEFF46_9606(lncRNA),URS0000EF0DB0_9606(lncRNA),URS0000EF1858_9606(lncRNA),URS0000EF21B0_9606(lncRNA),URS0000EF2DFF_9606(lncRNA),URS0000EF301C_9606(lncRNA),URS0000EF37E8_9606(lncRNA),URS0000EF3A9F_9606(lncRNA),URS0000EF3CF1_9606(lncRNA),URS0000EF3DF9_9606(lncRNA),URS0000EF3F1E_9606(lncRNA),URS0000EF4F8E_9606(lncRNA),URS0000EF5E17_9606(lncRNA),URS0000EF6DD5_9606(lncRNA),URS0001BC01A9_9606(snoRNA),URS0001BC8BCA_9606(snoRNA),URS0001BCAB26_9606(lncRNA),URS0001BD06A8_9606(lncRNA),URS0001BD6BA6_9606(lncRNA),URS0001BD6FE6_9606(snoRNA),URS0001BD846E_9606(lncRNA),URS0001BDD58E_9606(lncRNA),URS0001BDF7F4_9606(lncRNA),URS0001BDFE60_9606(lncRNA),URS0001BE0F38_9606(lncRNA),URS0001BE5B4C_9606(lncRNA),URS0001BE719F_9606(lncRNA),URS0001BE9A8D_9606(lncRNA),URS0001BEA6C7_9606(lncRNA),URS0001BEE0F5_9606(lncRNA),URS0001BEFAFF_9606(lncRNA),URS0001BF0F3B_9606(lncRNA),URS0001BF32E6_9606(lncRNA),URS0001BF8847_9606(lncRNA),URS0001BF88A5_9606(lncRNA),URS0001BF918D_9606(lncRNA),URS0001BF9715_9606(lncRNA),URS0001BF9F44_9606(lncRNA),URS0001C778E7_9606(lncRNA),URS0001E80857_9606(lncRNA),URS000224B7D5_9606(lncRNA),URS0002262841_9606(lncRNA),URS000226E769_9606(lncRNA),URS00022AF335_9606(lncRNA),URS00022AF3D3_9606(lncRNA),URS00022AF716_9606(lncRNA),URS00022AF98F_9606(lncRNA),URS00022AFC46_9606(lncRNA),URS00022B0198_9606(lncRNA),URS00022B0581_9606(lncRNA),URS00022B0956_9606(lncRNA),URS00022B0C17_9606(lncRNA),URS00022B14A8_9606(lncRNA),URS00022B2175_9606(lncRNA),URS00022B3507_9606(lncRNA),URS00022B437F_9606(lncRNA),URS00022B6E99_9606(lncRNA),URS00022B7711_9606(lncRNA),URS00022B781F_9606(lncRNA),URS00022B7FCB_9606(lncRNA),URS00022B81C8_9606(lncRNA),URS00022B81D1_9606(lncRNA),URS00022B87F3_9606(lncRNA),URS00022B87F5_9606(lncRNA),URS00022B8E00_9606(lncRNA)	A	SM-ONLY
chr18	49491658	49491730	-	225	225	0	RPL17(protein_coding),SNORD58B(snoRNA),URS00000C6189_9606(piRNA),URS00004BB247_9606(snoRNA),URS00009AD5E9_9606(lncRNA),URS0000D6D64D_9606(lncRNA),URS0000D6DD28_9606(lncRNA),URS0000D6E4A7_9606(lncRNA),URS0000D6ECE6_9606(lncRNA)	A	SM-PC
chrX	69672550	69672603	+	205	205	0	5S_rRNA(rRNA_pseudogene),URS0000513774_9606(piRNA),URS00006B32AE_9606(rRNA),URS0001BCDD7F_9606(lncRNA),URS0001BD8038_9606(lncRNA)	A	SM-ONLY
chr17	35151205	35151256	-	204	204	0	URS00003531AD_9606(piRNA),URS000037AA55_9606(piRNA),URS00005CB969_9606(misc_RNA),URS000096B15F_9606(ncRNA),URS0001BD38EB_9606(lncRNA)	A	SM-ONLY
chr18	49491295	49491348	-	173	173	0	RPL17(protein_coding),SNORD58A(snoRNA),URS000005BADB_9606(snoRNA),URS0000196107_9606(snoRNA),URS000028B672_9606(piRNA),URS00009AD5E9_9606(lncRNA),URS0000D6D64D_9606(lncRNA),URS0000D6DD28_9606(lncRNA),URS0000D6E4A7_9606(lncRNA),URS0000D6ECE6_9606(lncRNA),URS0001BC5A60_9606(snoRNA),URS0001BCA2A1_9606(snoRNA)	A	SM-PC
chr1	173866662	173866713	-	132	132	0	GAS5(lncRNA),URS0000361A8E_9606(snoRNA),URS0000699519_9606(snoRNA),URS000072F791_9606(snoRNA),URS0000830339_9606(snoRNA),URS00008B3431_9606(lncRNA),URS00008B3C85_9606(lncRNA),URS00008B4DAD_9606(lncRNA),URS00008B6DB9_9606(lncRNA),URS00008B7CE9_9606(lncRNA),URS00008B883D_9606(lncRNA),URS00008BB2ED_9606(lncRNA),URS00008BC666_9606(lncRNA),URS00008BD472_9606(lncRNA),URS00008C0058_9606(lncRNA),URS00008C090E_9606(lncRNA),URS00008C0A79_9606(lncRNA),URS00008C0C72_9606(lncRNA),URS00008C0D76_9606(lncRNA),URS00008C15F6_9606(lncRNA),URS00008C19D0_9606(lncRNA),URS00008C1BCE_9606(lncRNA),URS00008C2157_9606(lncRNA),URS00008C24EE_9606(lncRNA),URS00008C2BF5_9606(lncRNA),URS00008C2E96_9606(lncRNA),URS00008C371B_9606(lncRNA),URS00008C3A01_9606(lncRNA),URS00008C4009_9606(lncRNA),URS00009AE80F_9606(lncRNA),URS00009AEE8E_9606(lncRNA),URS00009B629F_9606(lncRNA),URS00009BA636_9606(lncRNA),URS00009BBB44_9606(lncRNA),URS00009BCE1D_9606(lncRNA),URS00009C227F_9606(lncRNA),URS00009C4337_9606(lncRNA),URS00009C4AE5_9606(lncRNA),URS0000A80260_9606(lncRNA),URS0000AB0ACF_9606(lncRNA),URS0000CCDF7F_9606(lncRNA),URS0000CCDFCD_9606(lncRNA),URS0000CCDFEE_9606(lncRNA),URS0000CCE004_9606(lncRNA),URS0000CCE03F_9606(lncRNA),URS0000CCE053_9606(lncRNA),URS0000CCE07A_9606(lncRNA),URS0000CCE0B6_9606(lncRNA),URS0000CCE0C1_9606(lncRNA),URS0000CCE0C7_9606(lncRNA),URS0000CCE0E6_9606(lncRNA),URS0000CCE0FF_9606(lncRNA),URS0000CCE104_9606(lncRNA),URS0000CCE10E_9606(lncRNA),URS0000CCE12A_9606(lncRNA),URS0000D56DBC_9606(lncRNA),URS0000D5711B_9606(lncRNA),URS0000D574C4_9606(lncRNA),URS0000D57AAB_9606(lncRNA),URS0000D57C33_9606(lncRNA),URS0000D57C9D_9606(lncRNA),URS0000D580E5_9606(lncRNA),URS0000D58B68_9606(lncRNA),URS0000D58CB2_9606(lncRNA),URS0000D58D56_9606(lncRNA),URS0000D58E93_9606(lncRNA),URS0000D5948E_9606(lncRNA),URS0000D5951F_9606(lncRNA),URS0000D59535_9606(lncRNA),URS0000D5A48C_9606(lncRNA),URS0000D5A608_9606(lncRNA),URS0000D5A76D_9606(lncRNA),URS0000D5AA2B_9606(lncRNA),URS0000D5AB45_9606(lncRNA),URS0000D5B449_9606(lncRNA),URS0000D5B48A_9606(lncRNA),URS0000D5C1C4_9606(lncRNA),URS0000D5C34A_9606(lncRNA),URS0000D5C393_9606(lncRNA),URS0000D5C3C1_9606(lncRNA),URS0000D5C5C1_9606(lncRNA),URS0000D5C60C_9606(lncRNA),URS0000D5C735_9606(lncRNA),URS0000D5C88D_9606(lncRNA),URS0000D5CD7C_9606(lncRNA),URS0000D5CE9A_9606(lncRNA),URS0000D5D155_9606(lncRNA),URS0000D5D3F7_9606(lncRNA),URS0000D5D74F_9606(lncRNA),URS0000D5DB9C_9606(lncRNA),URS0000EA0F94_9606(lncRNA),URS0000EF4377_9606(lncRNA),URS00019BF8D5_9606(lncRNA),URS0001BC70AB_9606(snoRNA),URS0001BCCF8B_9606(lncRNA),URS0001BCD56D_9606(lncRNA),URS0001BCD741_9606(lncRNA),URS0001BCDE3D_9606(lncRNA),URS0001BCE45E_9606(lncRNA),URS0001BCF2DD_9606(lncRNA),URS0001BD044C_9606(lncRNA),URS0001BD1A51_9606(lncRNA),URS0001BD3771_9606(lncRNA),URS0001BD3FEF_9606(lncRNA),URS0001BD4316_9606(lncRNA),URS0001BD50F2_9606(lncRNA),URS0001BD549F_9606(lncRNA),URS0001BD6878_9606(lncRNA),URS0001BD6EFB_9606(lncRNA),URS0001BD742C_9606(lncRNA),URS0001BD8757_9606(lncRNA),URS0001BDAB6D_9606(lncRNA),URS0001BDBD5F_9606(lncRNA),URS0001BDC64F_9606(lncRNA),URS0001BE02C6_9606(lncRNA),URS0001BE0468_9606(lncRNA),URS0001BE169A_9606(lncRNA),URS0001BE1BF4_9606(lncRNA),URS0001BE1F67_9606(lncRNA),URS0001BE2106_9606(lncRNA),URS0001BE22CC_9606(lncRNA),URS0001BE30C4_9606(lncRNA),URS0001BE4E6D_9606(lncRNA),URS0001BE55B9_9606(lncRNA),URS0001BE6D3C_9606(lncRNA),URS0001BE73B4_9606(lncRNA),URS0001BE9684_9606(lncRNA),URS0001BEA36A_9606(lncRNA),URS0001BEA4A7_9606(lncRNA),URS0001BEAF6D_9606(lncRNA),URS0001BEB416_9606(lncRNA),URS0001BEFBA2_9606(lncRNA),URS0001BEFBA8_9606(lncRNA),URS0001BEFF33_9606(lncRNA),URS0001BF0144_9606(lncRNA),URS0001BF03AF_9606(lncRNA),URS0001BF107B_9606(lncRNA),URS0001BF2483_9606(lncRNA),URS0001BF28F7_9606(lncRNA),URS0001BF5440_9606(lncRNA),URS0001BF738C_9606(lncRNA),URS0001BF8218_9606(lncRNA),URS0001BF8EC8_9606(lncRNA),URS0001BF9C77_9606(lncRNA),URS0001BF9F5D_9606(lncRNA),URS0001BFA1B0_9606(lncRNA),URS0001BFA68C_9606(lncRNA),URS00021FBAD5_9606(lncRNA),URS0002218A4A_9606(lncRNA),URS0002276C2D_9606(lncRNA),URS00022AE845_9606(lncRNA),URS00022AEE19_9606(lncRNA),URS00022AEEFE_9606(lncRNA),URS00022AF133_9606(lncRNA),URS00022B0225_9606(lncRNA),URS00022B0C15_9606(lncRNA),URS00022B137A_9606(lncRNA),URS00022B15AA_9606(lncRNA),URS00022B1858_9606(lncRNA),URS00022B1EF5_9606(lncRNA),URS00022B2095_9606(lncRNA),URS00022B21B2_9606(lncRNA),URS00022B2236_9606(lncRNA),URS00022B23C3_9606(lncRNA),URS00022B2A25_9606(lncRNA),URS00022B30ED_9606(lncRNA),URS00022B3120_9606(lncRNA),URS00022B3949_9606(lncRNA),URS00022B3A51_9606(lncRNA),URS00022B3D16_9606(lncRNA),URS00022B3D8A_9606(lncRNA),URS00022B3E09_9606(lncRNA),URS00022B3EF9_9606(lncRNA),URS00022B3FAD_9606(lncRNA),URS00022B45C4_9606(lncRNA),URS00022B461B_9606(lncRNA),URS00022B4821_9606(lncRNA),URS00022B4B51_9606(lncRNA),URS00022B575C_9606(lncRNA),URS00022B591C_9606(lncRNA),URS00022B5B49_9606(lncRNA),URS00022B5EC0_9606(lncRNA),URS00022B671C_9606(lncRNA),URS00022B74A0_9606(lncRNA),URS00022B7566_9606(lncRNA),URS00022B77FD_9606(lncRNA),URS00022B7A55_9606(lncRNA),URS00022B8675_9606(lncRNA),URS00022B8D24_9606(lncRNA),URS00022B8E31_9606(lncRNA),URS00022B8E3A_9606(lncRNA),URS00022B8FB5_9606(lncRNA),URS00022B8FC7_9606(lncRNA),URS00022B9426_9606(lncRNA),URS00022B9481_9606(lncRNA),URS00022B962E_9606(lncRNA)	A	SM-ONLY
chr1	75787071	75787124	+	126	126	0	RABGGTB(protein_coding),SNORD45C(snoRNA),URS0000668E0B_9606(snoRNA),URS0000759A7B_9606(snoRNA),URS00008BB85C_9606(lncRNA),URS0001BC3BE5_9606(snoRNA),URS0001BEBDCB_9606(lncRNA)	A	SM-PC
chr1	173864365	173864446	-	117	117	0	GAS5(lncRNA),URS00001E5D61_9606(snoRNA),URS0000507EBE_9606(snoRNA),URS000072F791_9606(snoRNA),URS00008B3431_9606(lncRNA),URS00008B3C85_9606(lncRNA),URS00008B41F4_9606(lncRNA),URS00008B4DAD_9606(lncRNA),URS00008B4E64_9606(lncRNA),URS00008B6DB9_9606(lncRNA),URS00008B7CE9_9606(lncRNA),URS00008B883D_9606(lncRNA),URS00008B9419_9606(lncRNA),URS00008B991F_9606(lncRNA),URS00008BB2ED_9606(lncRNA),URS00008BC666_9606(lncRNA),URS00008BCA3B_9606(lncRNA),URS00008BD472_9606(lncRNA),URS00008C0058_9606(lncRNA),URS00008C0A79_9606(lncRNA),URS00008C0D76_9606(lncRNA),URS00008C15F6_9606(lncRNA),URS00008C1BCE_9606(lncRNA),URS00008C2BF5_9606(lncRNA),URS00009AE664_9606(lncRNA),URS00009AE80F_9606(lncRNA),URS00009AEE8E_9606(lncRNA),URS00009B629F_9606(lncRNA),URS00009BA636_9606(lncRNA),URS00009BBB44_9606(lncRNA),URS00009BCE1D_9606(lncRNA),URS00009BED68_9606(lncRNA),URS00009C227F_9606(lncRNA),URS00009C4337_9606(lncRNA),URS00009C4AE5_9606(lncRNA),URS0000A80260_9606(lncRNA),URS0000CCDF7F_9606(lncRNA),URS0000CCDFCD_9606(lncRNA),URS0000CCDFEE_9606(lncRNA),URS0000CCE004_9606(lncRNA),URS0000CCE03F_9606(lncRNA),URS0000CCE053_9606(lncRNA),URS0000CCE07A_9606(lncRNA),URS0000CCE0B6_9606(lncRNA),URS0000CCE0C1_9606(lncRNA),URS0000CCE0C7_9606(lncRNA),URS0000CCE0E6_9606(lncRNA),URS0000CCE0FF_9606(lncRNA),URS0000CCE104_9606(lncRNA),URS0000CCE10E_9606(lncRNA),URS0000CCE12A_9606(lncRNA),URS0000D56DBC_9606(lncRNA),URS0000D574C4_9606(lncRNA),URS0000D57AAB_9606(lncRNA),URS0000D57C33_9606(lncRNA),URS0000D57C9D_9606(lncRNA),URS0000D58AD7_9606(lncRNA),URS0000D58B68_9606(lncRNA),URS0000D58CB2_9606(lncRNA),URS0000D58E93_9606(lncRNA),URS0000D5948E_9606(lncRNA),URS0000D59535_9606(lncRNA),URS0000D599CB_9606(lncRNA),URS0000D5A48C_9606(lncRNA),URS0000D5A608_9606(lncRNA),URS0000D5A702_9606(lncRNA),URS0000D5AA2B_9606(lncRNA),URS0000D5AB45_9606(lncRNA),URS0000D5B48A_9606(lncRNA),URS0000D5C34A_9606(lncRNA),URS0000D5C393_9606(lncRNA),URS0000D5C5C1_9606(lncRNA),URS0000D5C60C_9606(lncRNA),URS0000D5CE9A_9606(lncRNA),URS0000D5D155_9606(lncRNA),URS0000D5D3F7_9606(lncRNA),URS0000D5D74F_9606(lncRNA),URS0000D5DC38_9606(lncRNA),URS0000D5E306_9606(lncRNA),URS0000EA0F94_9606(lncRNA),URS0000EF4377_9606(lncRNA),URS00019BF8D5_9606(lncRNA),URS0001BC6D83_9606(snoRNA),URS0001BCB772_9606(lncRNA),URS0001BCCF8B_9606(lncRNA),URS0001BCD56D_9606(lncRNA),URS0001BCD741_9606(lncRNA),URS0001BCF2DD_9606(lncRNA),URS0001BD044C_9606(lncRNA),URS0001BD1A51_9606(lncRNA),URS0001BD3771_9606(lncRNA),URS0001BD3FEF_9606(lncRNA),URS0001BD50F2_9606(lncRNA),URS0001BD549F_9606(lncRNA),URS0001BD6878_9606(lncRNA),URS0001BD6EFB_9606(lncRNA),URS0001BD8757_9606(lncRNA),URS0001BDAB6D_9606(lncRNA),URS0001BDBD5F_9606(lncRNA),URS0001BDC64F_9606(lncRNA),URS0001BE02C6_9606(lncRNA),URS0001BE0468_9606(lncRNA),URS0001BE169A_9606(lncRNA),URS0001BE1BF4_9606(lncRNA),URS0001BE2106_9606(lncRNA),URS0001BE22CC_9606(lncRNA),URS0001BE26FF_9606(lncRNA),URS0001BE30C4_9606(lncRNA),URS0001BE55B9_9606(lncRNA),URS0001BE6D3C_9606(lncRNA),URS0001BE9684_9606(lncRNA),URS0001BEA4A7_9606(lncRNA),URS0001BEA965_9606(lncRNA),URS0001BEB416_9606(lncRNA),URS0001BED74D_9606(lncRNA),URS0001BEE491_9606(lncRNA),URS0001BEFBA8_9606(lncRNA),URS0001BEFF33_9606(lncRNA),URS0001BF0144_9606(lncRNA),URS0001BF03AF_9606(lncRNA),URS0001BF107B_9606(lncRNA),URS0001BF2483_9606(lncRNA),URS0001BF28F7_9606(lncRNA),URS0001BF3832_9606(lncRNA),URS0001BF5440_9606(lncRNA),URS0001BF6A47_9606(lncRNA),URS0001BF738C_9606(lncRNA),URS0001BF8EC8_9606(lncRNA),URS0001BF9C77_9606(lncRNA),URS0001BF9F5D_9606(lncRNA),URS0001BFA1B0_9606(lncRNA),URS0001BFA420_9606(lncRNA),URS0001BFA68C_9606(lncRNA),URS00021FBAD5_9606(lncRNA),URS0002218A4A_9606(lncRNA),URS0002276C2D_9606(lncRNA),URS00022AE845_9606(lncRNA),URS00022AEE19_9606(lncRNA),URS00022AEEFE_9606(lncRNA),URS00022AF133_9606(lncRNA),URS00022B0225_9606(lncRNA),URS00022B0C15_9606(lncRNA),URS00022B137A_9606(lncRNA),URS00022B15AA_9606(lncRNA),URS00022B1858_9606(lncRNA),URS00022B1EF5_9606(lncRNA),URS00022B2095_9606(lncRNA),URS00022B21B2_9606(lncRNA),URS00022B2236_9606(lncRNA),URS00022B23C3_9606(lncRNA),URS00022B2A25_9606(lncRNA),URS00022B30ED_9606(lncRNA),URS00022B3120_9606(lncRNA),URS00022B3949_9606(lncRNA),URS00022B3A51_9606(lncRNA),URS00022B3D16_9606(lncRNA),URS00022B3D8A_9606(lncRNA),URS00022B3E09_9606(lncRNA),URS00022B3EF9_9606(lncRNA),URS00022B3FAD_9606(lncRNA),URS00022B45C4_9606(lncRNA),URS00022B461B_9606(lncRNA),URS00022B4821_9606(lncRNA),URS00022B4B51_9606(lncRNA),URS00022B575C_9606(lncRNA),URS00022B591C_9606(lncRNA),URS00022B5B49_9606(lncRNA),URS00022B5EC0_9606(lncRNA),URS00022B671C_9606(lncRNA),URS00022B74A0_9606(lncRNA),URS00022B7566_9606(lncRNA),URS00022B77FD_9606(lncRNA),URS00022B7A55_9606(lncRNA),URS00022B8675_9606(lncRNA),URS00022B8D24_9606(lncRNA),URS00022B8E31_9606(lncRNA),URS00022B8E3A_9606(lncRNA),URS00022B8FB5_9606(lncRNA),URS00022B8FC7_9606(lncRNA),URS00022B9426_9606(lncRNA),URS00022B9481_9606(lncRNA),URS00022B962E_9606(lncRNA)	A	SM-ONLY
chr11	62853663	62853733	-	87	87	0	SNHG1(lncRNA),SNORD30(snoRNA),URS00001D24B1_9606(misc_RNA),URS00004E0FA9_9606(snoRNA),URS00005F4016_9606(misc_RNA),URS00008B57DA_9606(lncRNA),URS00008C0C32_9606(lncRNA),URS00008C0CC6_9606(lncRNA),URS00008C1085_9606(lncRNA),URS00008C1464_9606(lncRNA),URS00008C167B_9606(lncRNA),URS00008C1D08_9606(lncRNA),URS00008C2147_9606(lncRNA),URS00008C22A8_9606(lncRNA),URS00008C22F5_9606(lncRNA),URS00008C2432_9606(lncRNA),URS00008C24BC_9606(lncRNA),URS00008C2EDC_9606(lncRNA),URS00008C3031_9606(lncRNA),URS00008C355C_9606(lncRNA),URS00008C392D_9606(lncRNA),URS00008C3AA7_9606(lncRNA),URS00008C3E49_9606(lncRNA),URS00008C409D_9606(lncRNA),URS00009B63CD_9606(lncRNA),URS00009B9E39_9606(lncRNA),URS00009BAB70_9606(lncRNA),URS00009BB13E_9606(lncRNA),URS00009BC8FE_9606(lncRNA),URS00009BEBF4_9606(lncRNA),URS00009BF63C_9606(lncRNA),URS0000CCDF81_9606(lncRNA),URS0000CCDFCF_9606(lncRNA),URS0000CCDFDF_9606(lncRNA),URS0000CCE06F_9606(lncRNA),URS0000CCE076_9606(lncRNA),URS0000CCE0AB_9606(lncRNA),URS0000CCE0B4_9606(lncRNA),URS0000CCE0BC_9606(lncRNA),URS0000CCE0E1_9606(lncRNA),URS0000CCE108_9606(lncRNA),URS0000CCE128_9606(lncRNA),URS0000CCE14E_9606(lncRNA),URS0000D57192_9606(lncRNA),URS0000D5722B_9606(lncRNA),URS0000D57F9D_9606(lncRNA),URS0000D583DF_9606(lncRNA),URS0000D5874A_9606(lncRNA),URS0000D58A95_9606(lncRNA),URS0000D58D79_9606(lncRNA),URS0000D58E2D_9606(lncRNA),URS0000D58F0C_9606(lncRNA),URS0000D5976C_9606(lncRNA),URS0000D5A047_9606(lncRNA),URS0000D5A3CA_9606(lncRNA),URS0000D5A664_9606(lncRNA),URS0000D5A7A2_9606(lncRNA),URS0000D5AE9B_9606(lncRNA),URS0000D5B306_9606(lncRNA),URS0000D5B526_9606(lncRNA),URS0000D5BC0C_9606(lncRNA),URS0000D5C0E1_9606(lncRNA),URS0000D5C4AC_9606(lncRNA),URS0000D5C936_9606(lncRNA),URS0000D5C999_9606(lncRNA),URS0000D5CA9E_9606(lncRNA),URS0000D5CC94_9606(lncRNA),URS0000D5CE46_9606(lncRNA),URS0000D5D344_9606(lncRNA),URS0000D5DB22_9606(lncRNA),URS0000D5DF6D_9606(lncRNA),URS0000D5E3D8_9606(lncRNA),URS0000EEAEF8_9606(lncRNA),URS0000EEB6FE_9606(lncRNA),URS0000EEC386_9606(lncRNA),URS0000EEC677_9606(lncRNA),URS0000EEC7F2_9606(lncRNA),URS0000EECE76_9606(lncRNA),URS0000EEE090_9606(lncRNA),URS0000EEEED6_9606(lncRNA),URS0000EEF08F_9606(lncRNA),URS0000EEF2B0_9606(lncRNA),URS0000EEFB92_9606(lncRNA),URS0000EEFF3B_9606(lncRNA),URS0000EEFF46_9606(lncRNA),URS0000EF0DB0_9606(lncRNA),URS0000EF120E_9606(lncRNA),URS0000EF123A_9606(lncRNA),URS0000EF1858_9606(lncRNA),URS0000EF21B0_9606(lncRNA),URS0000EF2DFF_9606(lncRNA),URS0000EF301C_9606(lncRNA),URS0000EF3572_9606(lncRNA),URS0000EF37E8_9606(lncRNA),URS0000EF3A9F_9606(lncRNA),URS0000EF3CF1_9606(lncRNA),URS0000EF3DF9_9606(lncRNA),URS0000EF3F1E_9606(lncRNA),URS0000EF4F8E_9606(lncRNA),URS0000EF5E17_9606(lncRNA),URS0000EF6AE6_9606(lncRNA),URS0000EF6DD5_9606(lncRNA),URS00019EB4E2_9606(lncRNA),URS0001BC43A7_9606(snoRNA),URS0001BCAB26_9606(lncRNA),URS0001BCB0B6_9606(lncRNA),URS0001BCCC88_9606(lncRNA),URS0001BCD596_9606(lncRNA),URS0001BD52E5_9606(lncRNA),URS0001BD61A6_9606(lncRNA),URS0001BD6BA6_9606(lncRNA),URS0001BD6FE6_9606(snoRNA),URS0001BD846E_9606(lncRNA),URS0001BD9C2E_9606(lncRNA),URS0001BDD58E_9606(lncRNA),URS0001BDF7F4_9606(lncRNA),URS0001BDFE60_9606(lncRNA),URS0001BE1ECE_9606(lncRNA),URS0001BE2C73_9606(lncRNA),URS0001BE5B4C_9606(lncRNA),URS0001BE719F_9606(lncRNA),URS0001BE7311_9606(lncRNA),URS0001BE75DE_9606(lncRNA),URS0001BE9A8D_9606(lncRNA),URS0001BEA6C7_9606(lncRNA),URS0001BEE0F5_9606(lncRNA),URS0001BEE583_9606(lncRNA),URS0001BEFAFF_9606(lncRNA),URS0001BF0F3B_9606(lncRNA),URS0001BF2ABE_9606(lncRNA),URS0001BF7152_9606(lncRNA),URS0001BF78F6_9606(lncRNA),URS0001BF8051_9606(lncRNA),URS0001BF8847_9606(lncRNA),URS0001BF918D_9606(lncRNA),URS0001BF9715_9606(lncRNA),URS0001BF9F44_9606(lncRNA),URS0001C778E7_9606(lncRNA),URS0001E80857_9606(lncRNA),URS000224B7D5_9606(lncRNA),URS0002262841_9606(lncRNA),URS000226E769_9606(lncRNA),URS00022AF335_9606(lncRNA),URS00022AF3D3_9606(lncRNA),URS00022AF716_9606(lncRNA),URS00022AF98F_9606(lncRNA),URS00022AFC46_9606(lncRNA),URS00022B0198_9606(lncRNA),URS00022B0581_9606(lncRNA),URS00022B0956_9606(lncRNA),URS00022B0C17_9606(lncRNA),URS00022B14A8_9606(lncRNA),URS00022B2175_9606(lncRNA),URS00022B3507_9606(lncRNA),URS00022B437F_9606(lncRNA),URS00022B6E99_9606(lncRNA),URS00022B7711_9606(lncRNA),URS00022B781F_9606(lncRNA),URS00022B7FCB_9606(lncRNA),URS00022B81C8_9606(lncRNA),URS00022B81D1_9606(lncRNA),URS00022B82C5_9606(lncRNA),URS00022B87F3_9606(lncRNA),URS00022B87F5_9606(lncRNA),URS00022B8E00_9606(lncRNA)	A	SM-ONLY
chr20	2656622	2656698	+	66	66	0	NOP56(protein_coding),SNORD56(snoRNA),URS0000434604_9606(snoRNA),URS0000E15B0E_9606(lncRNA),URS0000E9622D_9606(lncRNA),URS0000EA6C03_9606(lncRNA),URS0000EB5A4C_9606(lncRNA),URS0001BC290B_9606(snoRNA)	A	SM-PC
chr1	173865377	173865429	-	64	64	0	GAS5(lncRNA),URS00001FCA45_9606(snoRNA),URS000067D064_9606(snoRNA),URS00006A5E9A_9606(snoRNA),URS000072F791_9606(snoRNA),URS00008B3431_9606(lncRNA),URS00008B3C85_9606(lncRNA),URS00008B4DAD_9606(lncRNA),URS00008B6DB9_9606(lncRNA),URS00008B7CE9_9606(lncRNA),URS00008B883D_9606(lncRNA),URS00008B991F_9606(lncRNA),URS00008BB2ED_9606(lncRNA),URS00008BC666_9606(lncRNA),URS00008BD472_9606(lncRNA),URS00008C0058_9606(lncRNA),URS00008C090E_9606(lncRNA),URS00008C0A79_9606(lncRNA),URS00008C0C72_9606(lncRNA),URS00008C0D76_9606(lncRNA),URS00008C15F6_9606(lncRNA),URS00008C19D0_9606(lncRNA),URS00008C1BCE_9606(lncRNA),URS00008C2157_9606(lncRNA),URS00008C2BF5_9606(lncRNA),URS00008C3A01_9606(lncRNA),URS00009AE664_9606(lncRNA),URS00009AE80F_9606(lncRNA),URS00009AEE8E_9606(lncRNA),URS00009B629F_9606(lncRNA),URS00009BA636_9606(lncRNA),URS00009BBB44_9606(lncRNA),URS00009BCE1D_9606(lncRNA),URS00009BED68_9606(lncRNA),URS00009C227F_9606(lncRNA),URS00009C4337_9606(lncRNA),URS00009C4AE5_9606(lncRNA),URS0000A80260_9606(lncRNA),URS0000AB0ACF_9606(lncRNA),URS0000CCDF7F_9606(lncRNA),URS0000CCDFCD_9606(lncRNA),URS0000CCDFEE_9606(lncRNA),URS0000CCE004_9606(lncRNA),URS0000CCE03F_9606(lncRNA),URS0000CCE053_9606(lncRNA),URS0000CCE07A_9606(lncRNA),URS0000CCE0B6_9606(lncRNA),URS0000CCE0C1_9606(lncRNA),URS0000CCE0C7_9606(lncRNA),URS0000CCE0E6_9606(lncRNA),URS0000CCE0FF_9606(lncRNA),URS0000CCE104_9606(lncRNA),URS0000CCE10E_9606(lncRNA),URS0000CCE12A_9606(lncRNA),URS0000D56DBC_9606(lncRNA),URS0000D574C4_9606(lncRNA),URS0000D57AAB_9606(lncRNA),URS0000D57C33_9606(lncRNA),URS0000D57C9D_9606(lncRNA),URS0000D580E5_9606(lncRNA),URS0000D58B68_9606(lncRNA),URS0000D58CB2_9606(lncRNA),URS0000D58E93_9606(lncRNA),URS0000D5948E_9606(lncRNA),URS0000D59535_9606(lncRNA),URS0000D5A48C_9606(lncRNA),URS0000D5A608_9606(lncRNA),URS0000D5A702_9606(lncRNA),URS0000D5A76D_9606(lncRNA),URS0000D5AA2B_9606(lncRNA),URS0000D5AB45_9606(lncRNA),URS0000D5B48A_9606(lncRNA),URS0000D5C34A_9606(lncRNA),URS0000D5C393_9606(lncRNA),URS0000D5C5C1_9606(lncRNA),URS0000D5C60C_9606(lncRNA),URS0000D5C735_9606(lncRNA),URS0000D5C88D_9606(lncRNA),URS0000D5CE9A_9606(lncRNA),URS0000D5D155_9606(lncRNA),URS0000D5D3F7_9606(lncRNA),URS0000D5D74F_9606(lncRNA),URS0000D5DB9C_9606(lncRNA),URS0000EA0F94_9606(lncRNA),URS0000EF4377_9606(lncRNA),URS00019BF8D5_9606(lncRNA),URS0001BC267F_9606(snoRNA),URS0001BC8C09_9606(snoRNA),URS0001BCCF8B_9606(lncRNA),URS0001BCD56D_9606(lncRNA),URS0001BCD741_9606(lncRNA),URS0001BCE45E_9606(lncRNA),URS0001BCF2DD_9606(lncRNA),URS0001BD044C_9606(lncRNA),URS0001BD1A51_9606(lncRNA),URS0001BD3771_9606(lncRNA),URS0001BD3FEF_9606(lncRNA),URS0001BD4316_9606(lncRNA),URS0001BD50F2_9606(lncRNA),URS0001BD549F_9606(lncRNA),URS0001BD6878_9606(lncRNA),URS0001BD6EFB_9606(lncRNA),URS0001BD8757_9606(lncRNA),URS0001BDAB6D_9606(lncRNA),URS0001BDBD5F_9606(lncRNA),URS0001BDC64F_9606(lncRNA),URS0001BE02C6_9606(lncRNA),URS0001BE0468_9606(lncRNA),URS0001BE169A_9606(lncRNA),URS0001BE1BF4_9606(lncRNA),URS0001BE1F67_9606(lncRNA),URS0001BE2106_9606(lncRNA),URS0001BE22CC_9606(lncRNA),URS0001BE30C4_9606(lncRNA),URS0001BE55B9_9606(lncRNA),URS0001BE6D3C_9606(lncRNA),URS0001BE9684_9606(lncRNA),URS0001BEA36A_9606(lncRNA),URS0001BEA4A7_9606(lncRNA),URS0001BEA965_9606(lncRNA),URS0001BEB416_9606(lncRNA),URS0001BED74D_9606(lncRNA),URS0001BEFBA2_9606(lncRNA),URS0001BEFBA8_9606(lncRNA),URS0001BEFF33_9606(lncRNA),URS0001BF0144_9606(lncRNA),URS0001BF03AF_9606(lncRNA),URS0001BF107B_9606(lncRNA),URS0001BF2483_9606(lncRNA),URS0001BF28F7_9606(lncRNA),URS0001BF3832_9606(lncRNA),URS0001BF5440_9606(lncRNA),URS0001BF738C_9606(lncRNA),URS0001BF8218_9606(lncRNA),URS0001BF8EC8_9606(lncRNA),URS0001BF9C77_9606(lncRNA),URS0001BF9F5D_9606(lncRNA),URS0001BFA1B0_9606(lncRNA),URS0001BFA68C_9606(lncRNA),URS00021FBAD5_9606(lncRNA),URS0002218A4A_9606(lncRNA),URS0002276C2D_9606(lncRNA),URS00022AE845_9606(lncRNA),URS00022AEE19_9606(lncRNA),URS00022AEEFE_9606(lncRNA),URS00022AF133_9606(lncRNA),URS00022B0225_9606(lncRNA),URS00022B0C15_9606(lncRNA),URS00022B137A_9606(lncRNA),URS00022B15AA_9606(lncRNA),URS00022B1858_9606(lncRNA),URS00022B1EF5_9606(lncRNA),URS00022B2095_9606(lncRNA),URS00022B21B2_9606(lncRNA),URS00022B2236_9606(lncRNA),URS00022B23C3_9606(lncRNA),URS00022B2A25_9606(lncRNA),URS00022B30ED_9606(lncRNA),URS00022B3120_9606(lncRNA),URS00022B3949_9606(lncRNA),URS00022B3A51_9606(lncRNA),URS00022B3D16_9606(lncRNA),URS00022B3D8A_9606(lncRNA),URS00022B3E09_9606(lncRNA),URS00022B3EF9_9606(lncRNA),URS00022B3FAD_9606(lncRNA),URS00022B45C4_9606(lncRNA),URS00022B461B_9606(lncRNA),URS00022B4821_9606(lncRNA),URS00022B4B51_9606(lncRNA),URS00022B575C_9606(lncRNA),URS00022B591C_9606(lncRNA),URS00022B5B49_9606(lncRNA),URS00022B5EC0_9606(lncRNA),URS00022B671C_9606(lncRNA),URS00022B74A0_9606(lncRNA),URS00022B7566_9606(lncRNA),URS00022B77FD_9606(lncRNA),URS00022B7A55_9606(lncRNA),URS00022B8675_9606(lncRNA),URS00022B8D24_9606(lncRNA),URS00022B8E31_9606(lncRNA),URS00022B8E3A_9606(lncRNA),URS00022B8FB5_9606(lncRNA),URS00022B8FC7_9606(lncRNA),URS00022B9426_9606(lncRNA),URS00022B9481_9606(lncRNA),URS00022B962E_9606(lncRNA)	A	SM-ONLY
chr1	173866873	173866939	-	63	63	0	GAS5(lncRNA),URS00001E5676_9606(piRNA),URS000026D828_9606(snoRNA),URS000058646C_9606(piRNA),URS00005B0A8F_9606(piRNA),URS00006125F6_9606(piRNA),URS000072F791_9606(snoRNA),URS00008B3431_9606(lncRNA),URS00008B3C85_9606(lncRNA),URS00008B4DAD_9606(lncRNA),URS00008B6DB9_9606(lncRNA),URS00008B7CE9_9606(lncRNA),URS00008B883D_9606(lncRNA),URS00008BB2ED_9606(lncRNA),URS00008BC666_9606(lncRNA),URS00008BD472_9606(lncRNA),URS00008C0058_9606(lncRNA),URS00008C090E_9606(lncRNA),URS00008C0A79_9606(lncRNA),URS00008C0C72_9606(lncRNA),URS00008C0D76_9606(lncRNA),URS00008C15F6_9606(lncRNA),URS00008C19D0_9606(lncRNA),URS00008C1BCE_9606(lncRNA),URS00008C2157_9606(lncRNA),URS00008C24EE_9606(lncRNA),URS00008C2BF5_9606(lncRNA),URS00008C2E96_9606(lncRNA),URS00008C371B_9606(lncRNA),URS00008C3A01_9606(lncRNA),URS00008C4009_9606(lncRNA),URS00009AE80F_9606(lncRNA),URS00009AEE8E_9606(lncRNA),URS00009B629F_9606(lncRNA),URS00009BA636_9606(lncRNA),URS00009BBB44_9606(lncRNA),URS00009BCE1D_9606(lncRNA),URS00009C227F_9606(lncRNA),URS00009C4337_9606(lncRNA),URS00009C4AE5_9606(lncRNA),URS0000A80260_9606(lncRNA),URS0000AB0ACF_9606(lncRNA),URS0000CCDF7F_9606(lncRNA),URS0000CCDFCD_9606(lncRNA),URS0000CCDFEE_9606(lncRNA),URS0000CCE004_9606(lncRNA),URS0000CCE03F_9606(lncRNA),URS0000CCE053_9606(lncRNA),URS0000CCE07A_9606(lncRNA),URS0000CCE0B6_9606(lncRNA),URS0000CCE0C1_9606(lncRNA),URS0000CCE0C7_9606(lncRNA),URS0000CCE0E6_9606(lncRNA),URS0000CCE0FF_9606(lncRNA),URS0000CCE104_9606(lncRNA),URS0000CCE10E_9606(lncRNA),URS0000CCE12A_9606(lncRNA),URS0000D56DBC_9606(lncRNA),URS0000D5711B_9606(lncRNA),URS0000D574C4_9606(lncRNA),URS0000D57AAB_9606(lncRNA),URS0000D57C33_9606(lncRNA),URS0000D57C9D_9606(lncRNA),URS0000D580E5_9606(lncRNA),URS0000D58B68_9606(lncRNA),URS0000D58CB2_9606(lncRNA),URS0000D58D56_9606(lncRNA),URS0000D58E93_9606(lncRNA),URS0000D5948E_9606(lncRNA),URS0000D59535_9606(lncRNA),URS0000D5A48C_9606(lncRNA),URS0000D5A76D_9606(lncRNA),URS0000D5AA2B_9606(lncRNA),URS0000D5AB45_9606(lncRNA),URS0000D5B449_9606(lncRNA),URS0000D5B48A_9606(lncRNA),URS0000D5C1C4_9606(lncRNA),URS0000D5C34A_9606(lncRNA),URS0000D5C393_9606(lncRNA),URS0000D5C3C1_9606(lncRNA),URS0000D5C5C1_9606(lncRNA),URS0000D5C60C_9606(lncRNA),URS0000D5C735_9606(lncRNA),URS0000D5C88D_9606(lncRNA),URS0000D5CD7C_9606(lncRNA),URS0000D5CE9A_9606(lncRNA),URS0000D5D155_9606(lncRNA),URS0000D5D3F7_9606(lncRNA),URS0000D5D74F_9606(lncRNA),URS0000D5DB9C_9606(lncRNA),URS0000EA0F94_9606(lncRNA),URS0000EF4377_9606(lncRNA),URS00019BF8D5_9606(lncRNA),URS0001BC98A4_9606(snoRNA),URS0001BCCF8B_9606(lncRNA),URS0001BCD56D_9606(lncRNA),URS0001BCD741_9606(lncRNA),URS0001BCDE3D_9606(lncRNA),URS0001BCE45E_9606(lncRNA),URS0001BCF2DD_9606(lncRNA),URS0001BD044C_9606(lncRNA),URS0001BD1A51_9606(lncRNA),URS0001BD3771_9606(lncRNA),URS0001BD3FEF_9606(lncRNA),URS0001BD4316_9606(lncRNA),URS0001BD50F2_9606(lncRNA),URS0001BD549F_9606(lncRNA),URS0001BD6878_9606(lncRNA),URS0001BD6EFB_9606(lncRNA),URS0001BD742C_9606(lncRNA),URS0001BD8757_9606(lncRNA),URS0001BDAB6D_9606(lncRNA),URS0001BDBD5F_9606(lncRNA),URS0001BDC64F_9606(lncRNA),URS0001BE02C6_9606(lncRNA),URS0001BE0468_9606(lncRNA),URS0001BE169A_9606(lncRNA),URS0001BE1BF4_9606(lncRNA),URS0001BE1F67_9606(lncRNA),URS0001BE2106_9606(lncRNA),URS0001BE22CC_9606(lncRNA),URS0001BE4E6D_9606(lncRNA),URS0001BE55B9_9606(lncRNA),URS0001BE6D3C_9606(lncRNA),URS0001BE73B4_9606(lncRNA),URS0001BE9684_9606(lncRNA),URS0001BEA36A_9606(lncRNA),URS0001BEA4A7_9606(lncRNA),URS0001BEAF6D_9606(lncRNA),URS0001BEB416_9606(lncRNA),URS0001BEFBA2_9606(lncRNA),URS0001BEFBA8_9606(lncRNA),URS0001BEFF33_9606(lncRNA),URS0001BF0144_9606(lncRNA),URS0001BF03AF_9606(lncRNA),URS0001BF107B_9606(lncRNA),URS0001BF2483_9606(lncRNA),URS0001BF28F7_9606(lncRNA),URS0001BF5440_9606(lncRNA),URS0001BF738C_9606(lncRNA),URS0001BF8218_9606(lncRNA),URS0001BF8EC8_9606(lncRNA),URS0001BF9C77_9606(lncRNA),URS0001BF9F5D_9606(lncRNA),URS0001BFA1B0_9606(lncRNA),URS0001BFA68C_9606(lncRNA),URS00021FBAD5_9606(lncRNA),URS0002218A4A_9606(lncRNA),URS0002276C2D_9606(lncRNA),URS00022AE845_9606(lncRNA),URS00022AEE19_9606(lncRNA),URS00022AEEFE_9606(lncRNA),URS00022AF133_9606(lncRNA),URS00022B0225_9606(lncRNA),URS00022B0C15_9606(lncRNA),URS00022B137A_9606(lncRNA),URS00022B15AA_9606(lncRNA),URS00022B1858_9606(lncRNA),URS00022B1EF5_9606(lncRNA),URS00022B2095_9606(lncRNA),URS00022B21B2_9606(lncRNA),URS00022B2236_9606(lncRNA),URS00022B23C3_9606(lncRNA),URS00022B2A25_9606(lncRNA),URS00022B30ED_9606(lncRNA),URS00022B3120_9606(lncRNA),URS00022B3949_9606(lncRNA),URS00022B3A51_9606(lncRNA),URS00022B3D16_9606(lncRNA),URS00022B3D8A_9606(lncRNA),URS00022B3E09_9606(lncRNA),URS00022B3EF9_9606(lncRNA),URS00022B3FAD_9606(lncRNA),URS00022B45C4_9606(lncRNA),URS00022B461B_9606(lncRNA),URS00022B4821_9606(lncRNA),URS00022B4B51_9606(lncRNA),URS00022B575C_9606(lncRNA),URS00022B591C_9606(lncRNA),URS00022B5B49_9606(lncRNA),URS00022B5EC0_9606(lncRNA),URS00022B671C_9606(lncRNA),URS00022B74A0_9606(lncRNA),URS00022B7566_9606(lncRNA),URS00022B77FD_9606(lncRNA),URS00022B7A55_9606(lncRNA),URS00022B8675_9606(lncRNA),URS00022B8D24_9606(lncRNA),URS00022B8E31_9606(lncRNA),URS00022B8E3A_9606(lncRNA),URS00022B8FB5_9606(lncRNA),URS00022B8FC7_9606(lncRNA),URS00022B9426_9606(lncRNA),URS00022B9481_9606(lncRNA),URS00022B962E_9606(lncRNA)	A	SM-ONLY
chr17	28722583	28722635	+	51	51	0	SNORD4A(snoRNA),URS000040EEF5_9606(piRNA),URS000046CCFB_9606(snoRNA),URS0001BCA182_9606(snoRNA)	A	SM-ONLY
chr1	173865621	173865686	-	46	46	0	GAS5(lncRNA),URS0000369E74_9606(snoRNA),URS00006CFC33_9606(snoRNA),URS000072F791_9606(snoRNA),URS00008B3431_9606(lncRNA),URS00008B3C85_9606(lncRNA),URS00008B4DAD_9606(lncRNA),URS00008B6DB9_9606(lncRNA),URS00008B7CE9_9606(lncRNA),URS00008B883D_9606(lncRNA),URS00008B991F_9606(lncRNA),URS00008BB2ED_9606(lncRNA),URS00008BC666_9606(lncRNA),URS00008BD472_9606(lncRNA),URS00008C0058_9606(lncRNA),URS00008C090E_9606(lncRNA),URS00008C0A79_9606(lncRNA),URS00008C0C72_9606(lncRNA),URS00008C0D76_9606(lncRNA),URS00008C15F6_9606(lncRNA),URS00008C19D0_9606(lncRNA),URS00008C1BCE_9606(lncRNA),URS00008C2157_9606(lncRNA),URS00008C2BF5_9606(lncRNA),URS00008C371B_9606(lncRNA),URS00008C3A01_9606(lncRNA),URS00009AE664_9606(lncRNA),URS00009AE80F_9606(lncRNA),URS00009AEE8E_9606(lncRNA),URS00009B629F_9606(lncRNA),URS00009BA636_9606(lncRNA),URS00009BBB44_9606(lncRNA),URS00009BCE1D_9606(lncRNA),URS00009BED68_9606(lncRNA),URS00009C227F_9606(lncRNA),URS00009C4337_9606(lncRNA),URS00009C4AE5_9606(lncRNA),URS0000A80260_9606(lncRNA),URS0000AB0ACF_9606(lncRNA),URS0000CCDF7F_9606(lncRNA),URS0000CCDFCD_9606(lncRNA),URS0000CCDFEE_9606(lncRNA),URS0000CCE004_9606(lncRNA),URS0000CCE03F_9606(lncRNA),URS0000CCE053_9606(lncRNA),URS0000CCE07A_9606(lncRNA),URS0000CCE0B6_9606(lncRNA),URS0000CCE0C1_9606(lncRNA),URS0000CCE0C7_9606(lncRNA),URS0000CCE0E6_9606(lncRNA),URS0000CCE0FF_9606(lncRNA),URS0000CCE104_9606(lncRNA),URS0000CCE10E_9606(lncRNA),URS0000CCE12A_9606(lncRNA),URS0000D56DBC_9606(lncRNA),URS0000D574C4_9606(lncRNA),URS0000D57AAB_9606(lncRNA),URS0000D57C33_9606(lncRNA),URS0000D57C9D_9606(lncRNA),URS0000D580E5_9606(lncRNA),URS0000D58B68_9606(lncRNA),URS0000D58CB2_9606(lncRNA),URS0000D58D56_9606(lncRNA),URS0000D58E93_9606(lncRNA),URS0000D5948E_9606(lncRNA),URS0000D59535_9606(lncRNA),URS0000D5A48C_9606(lncRNA),URS0000D5A608_9606(lncRNA),URS0000D5A76D_9606(lncRNA),URS0000D5AA2B_9606(lncRNA),URS0000D5AB45_9606(lncRNA),URS0000D5B48A_9606(lncRNA),URS0000D5C34A_9606(lncRNA),URS0000D5C393_9606(lncRNA),URS0000D5C5C1_9606(lncRNA),URS0000D5C60C_9606(lncRNA),URS0000D5C735_9606(lncRNA),URS0000D5C88D_9606(lncRNA),URS0000D5CE9A_9606(lncRNA),URS0000D5D155_9606(lncRNA),URS0000D5D3F7_9606(lncRNA),URS0000D5D74F_9606(lncRNA),URS0000D5DB9C_9606(lncRNA),URS0000EA0F94_9606(lncRNA),URS0000EF4377_9606(lncRNA),URS00019BF8D5_9606(lncRNA),URS0001BC74E1_9606(snoRNA),URS0001BCCF8B_9606(lncRNA),URS0001BCD56D_9606(lncRNA),URS0001BCD741_9606(lncRNA),URS0001BCE45E_9606(lncRNA),URS0001BCF2DD_9606(lncRNA),URS0001BD044C_9606(lncRNA),URS0001BD1A51_9606(lncRNA),URS0001BD3771_9606(lncRNA),URS0001BD3FEF_9606(lncRNA),URS0001BD4316_9606(lncRNA),URS0001BD50F2_9606(lncRNA),URS0001BD549F_9606(lncRNA),URS0001BD6878_9606(lncRNA),URS0001BD6EFB_9606(lncRNA),URS0001BD8757_9606(lncRNA),URS0001BDAB6D_9606(lncRNA),URS0001BDBD5F_9606(lncRNA),URS0001BDC64F_9606(lncRNA),URS0001BE02C6_9606(lncRNA),URS0001BE0468_9606(lncRNA),URS0001BE169A_9606(lncRNA),URS0001BE1BF4_9606(lncRNA),URS0001BE1F67_9606(lncRNA),URS0001BE2106_9606(lncRNA),URS0001BE22CC_9606(lncRNA),URS0001BE30C4_9606(lncRNA),URS0001BE4E6D_9606(lncRNA),URS0001BE55B9_9606(lncRNA),URS0001BE6D3C_9606(lncRNA),URS0001BE73B4_9606(lncRNA),URS0001BE9684_9606(lncRNA),URS0001BEA36A_9606(lncRNA),URS0001BEA4A7_9606(lncRNA),URS0001BEA965_9606(lncRNA),URS0001BEB416_9606(lncRNA),URS0001BED74D_9606(lncRNA),URS0001BEFBA2_9606(lncRNA),URS0001BEFBA8_9606(lncRNA),URS0001BEFF33_9606(lncRNA),URS0001BF0144_9606(lncRNA),URS0001BF03AF_9606(lncRNA),URS0001BF107B_9606(lncRNA),URS0001BF2483_9606(lncRNA),URS0001BF28F7_9606(lncRNA),URS0001BF5440_9606(lncRNA),URS0001BF738C_9606(lncRNA),URS0001BF8218_9606(lncRNA),URS0001BF8EC8_9606(lncRNA),URS0001BF9C77_9606(lncRNA),URS0001BF9F5D_9606(lncRNA),URS0001BFA1B0_9606(lncRNA),URS0001BFA68C_9606(lncRNA),URS00021FBAD5_9606(lncRNA),URS0002218A4A_9606(lncRNA),URS0002276C2D_9606(lncRNA),URS00022AE845_9606(lncRNA),URS00022AEE19_9606(lncRNA),URS00022AEEFE_9606(lncRNA),URS00022AF133_9606(lncRNA),URS00022B0225_9606(lncRNA),URS00022B0C15_9606(lncRNA),URS00022B137A_9606(lncRNA),URS00022B15AA_9606(lncRNA),URS00022B1858_9606(lncRNA),URS00022B1EF5_9606(lncRNA),URS00022B2095_9606(lncRNA),URS00022B21B2_9606(lncRNA),URS00022B2236_9606(lncRNA),URS00022B23C3_9606(lncRNA),URS00022B2A25_9606(lncRNA),URS00022B30ED_9606(lncRNA),URS00022B3120_9606(lncRNA),URS00022B3949_9606(lncRNA),URS00022B3A51_9606(lncRNA),URS00022B3D16_9606(lncRNA),URS00022B3D8A_9606(lncRNA),URS00022B3E09_9606(lncRNA),URS00022B3EF9_9606(lncRNA),URS00022B3FAD_9606(lncRNA),URS00022B45C4_9606(lncRNA),URS00022B461B_9606(lncRNA),URS00022B4821_9606(lncRNA),URS00022B4B51_9606(lncRNA),URS00022B575C_9606(lncRNA),URS00022B591C_9606(lncRNA),URS00022B5B49_9606(lncRNA),URS00022B5EC0_9606(lncRNA),URS00022B671C_9606(lncRNA),URS00022B74A0_9606(lncRNA),URS00022B7566_9606(lncRNA),URS00022B77FD_9606(lncRNA),URS00022B7A55_9606(lncRNA),URS00022B8675_9606(lncRNA),URS00022B8D24_9606(lncRNA),URS00022B8E31_9606(lncRNA),URS00022B8E3A_9606(lncRNA),URS00022B8FB5_9606(lncRNA),URS00022B8FC7_9606(lncRNA),URS00022B9426_9606(lncRNA),URS00022B9481_9606(lncRNA),URS00022B962E_9606(lncRNA)	A	SM-ONLY
chr17	16439504	16439556	+	33	33	0	SNHG29(lncRNA),SNORD49B(snoRNA),URS0000660E95_9606(snoRNA),URS000075992B_9606(lncRNA),URS0000759A29_9606(lncRNA),URS000075A2C0_9606(lncRNA),URS000075A366_9606(lncRNA),URS000075A6C5_9606(lncRNA),URS000075A7AE_9606(lncRNA),URS000075A7D4_9606(lncRNA),URS000075AA37_9606(lncRNA),URS000075AE43_9606(lncRNA),URS000075AE9D_9606(lncRNA),URS000075B39E_9606(snoRNA),URS000075BC33_9606(lncRNA),URS000075BFEA_9606(lncRNA),URS000075C121_9606(lncRNA),URS000075C1E5_9606(lncRNA),URS000075C273_9606(lncRNA),URS000075C465_9606(lncRNA),URS000075C789_9606(lncRNA),URS000075CC86_9606(lncRNA),URS000075CD39_9606(lncRNA),URS000075CD68_9606(lncRNA),URS000075CD85_9606(lncRNA),URS000075CDD3_9606(lncRNA),URS000075D276_9606(lncRNA),URS000075D7B9_9606(lncRNA),URS000075DF3E_9606(lncRNA),URS000075E65C_9606(lncRNA),URS000075E97C_9606(lncRNA),URS000075E980_9606(lncRNA),URS000075EB32_9606(lncRNA),URS000075EB6C_9606(lncRNA),URS000075EF93_9606(lncRNA),URS000075EFBA_9606(lncRNA),URS00009AD252_9606(lncRNA),URS00009AD4B2_9606(lncRNA),URS00009AE3D8_9606(lncRNA),URS00009AE8B9_9606(lncRNA),URS00009AEA42_9606(lncRNA),URS00009AEDBA_9606(lncRNA),URS00009AF65E_9606(lncRNA),URS00009AF812_9606(lncRNA),URS00009AF8F7_9606(lncRNA),URS00009B194C_9606(lncRNA),URS00009B1F4B_9606(lncRNA),URS00009B2FA1_9606(lncRNA),URS00009B3929_9606(lncRNA),URS00009B3F63_9606(lncRNA),URS00009B3FFD_9606(lncRNA),URS00009B56A4_9606(lncRNA),URS00009B5F97_9606(lncRNA),URS00009B717E_9606(lncRNA),URS00009B744B_9606(lncRNA),URS00009B87D1_9606(lncRNA),URS00009B8847_9606(lncRNA),URS00009B88CC_9606(lncRNA),URS00009B9C37_9606(lncRNA),URS00009B9D43_9606(lncRNA),URS00009BB2A5_9606(lncRNA),URS00009BB7BE_9606(lncRNA),URS00009BD4AC_9606(lncRNA),URS00009BD84B_9606(lncRNA),URS00009BDAFB_9606(lncRNA),URS00009BDE33_9606(lncRNA),URS00009BE037_9606(lncRNA),URS00009BF5B4_9606(lncRNA),URS00009BF602_9606(lncRNA),URS00009BFAE5_9606(lncRNA),URS00009C0CD0_9606(lncRNA),URS00009C1670_9606(lncRNA),URS00009C2B3A_9606(lncRNA),URS00009C3024_9606(lncRNA),URS00009C368D_9606(lncRNA),URS00009C5136_9606(lncRNA),URS00009C53A9_9606(lncRNA),URS00009C553A_9606(lncRNA),URS0000A7AE13_9606(lncRNA),URS0000A7C473_9606(lncRNA),URS0000A7EF6B_9606(lncRNA),URS0000A7FF18_9606(lncRNA),URS0000A80BF3_9606(lncRNA),URS0000A87CEC_9606(lncRNA),URS0000A8A1ED_9606(lncRNA),URS0000A8E72C_9606(lncRNA),URS0000A90555_9606(lncRNA),URS0000A9116B_9606(lncRNA),URS0000A9C7D0_9606(lncRNA),URS0000A9FD66_9606(lncRNA),URS0000AA17A5_9606(lncRNA),URS0000AA5C17_9606(lncRNA),URS0000AA6DF0_9606(lncRNA),URS0000AA76A0_9606(lncRNA),URS0000AA94C3_9606(lncRNA),URS0000AAAA45_9606(lncRNA),URS0000AAAD0B_9606(lncRNA),URS0000AAE978_9606(lncRNA),URS0000D58294_9606(lncRNA),URS0000D59E4B_9606(lncRNA),URS0000D59EF5_9606(lncRNA),URS0000D5A138_9606(lncRNA),URS0000D5A356_9606(lncRNA),URS0000D5D2EA_9606(lncRNA),URS0000EACC24_9606(lncRNA),URS0000EEB279_9606(lncRNA),URS0000EEB2B3_9606(lncRNA),URS0000EEB3DC_9606(lncRNA),URS0000EEBC40_9606(lncRNA),URS0000EEE0ED_9606(lncRNA),URS0000EEF0A7_9606(lncRNA),URS0000EEF1C7_9606(lncRNA),URS0000EEFA58_9606(lncRNA),URS0000EEFF66_9606(lncRNA),URS0000EF0287_9606(lncRNA),URS0000EF063A_9606(lncRNA),URS0000EF0655_9606(lncRNA),URS0000EF084F_9606(lncRNA),URS0000EF0ABF_9606(lncRNA),URS0000EF11CF_9606(lncRNA),URS0000EF1319_9606(lncRNA),URS0000EF2541_9606(lncRNA),URS0000EF2697_9606(lncRNA),URS0000EF27CE_9606(lncRNA),URS0000EF28AC_9606(lncRNA),URS0000EF2F79_9606(lncRNA),URS0000EF3757_9606(lncRNA),URS0000EF3B27_9606(lncRNA),URS0000EF3BDA_9606(lncRNA),URS0000EF3C23_9606(lncRNA),URS0000EF3EF1_9606(lncRNA),URS0000EF50B5_9606(lncRNA),URS0000EF59E1_9606(lncRNA),URS0000EF619B_9606(lncRNA),URS0000EF61CE_9606(lncRNA),URS0000EF6A8E_9606(lncRNA),URS0001BC8B03_9606(snoRNA),URS0001BCBA6E_9606(lncRNA),URS0001BCD003_9606(lncRNA),URS0001BCD89B_9606(lncRNA),URS0001BCDD44_9606(lncRNA),URS0001BCE27B_9606(lncRNA),URS0001BCE2E8_9606(lncRNA),URS0001BCEA2F_9606(lncRNA),URS0001BCF7B7_9606(lncRNA),URS0001BCF87A_9606(lncRNA),URS0001BD065A_9606(lncRNA),URS0001BD11CC_9606(lncRNA),URS0001BD2BD3_9606(lncRNA),URS0001BD345F_9606(lncRNA),URS0001BD547C_9606(lncRNA),URS0001BD567C_9606(lncRNA),URS0001BD7917_9606(lncRNA),URS0001BD7BC5_9606(lncRNA),URS0001BD8299_9606(lncRNA),URS0001BD88AF_9606(lncRNA),URS0001BD9E51_9606(lncRNA),URS0001BDC1B9_9606(lncRNA),URS0001BDCA58_9606(lncRNA),URS0001BDEC50_9606(lncRNA),URS0001BDF7A4_9606(lncRNA),URS0001BDFAF1_9606(lncRNA),URS0001BDFF7E_9606(lncRNA),URS0001BE03F3_9606(lncRNA),URS0001BE28B3_9606(lncRNA),URS0001BE3640_9606(lncRNA),URS0001BE3B59_9606(lncRNA),URS0001BE4282_9606(lncRNA),URS0001BE568F_9606(lncRNA),URS0001BE6111_9606(lncRNA),URS0001BE7A15_9606(lncRNA),URS0001BE82B4_9606(lncRNA),URS0001BEBB50_9606(lncRNA),URS0001BECA85_9606(lncRNA),URS0001BF0E46_9606(lncRNA),URS0001BF34F2_9606(lncRNA),URS0001BF51E8_9606(lncRNA),URS0001BF572A_9606(lncRNA),URS0001BF5F14_9606(lncRNA),URS0001BF6529_9606(lncRNA),URS0001BFA3AE_9606(lncRNA),URS0001F0ED11_9606(lncRNA),URS0001FE5747_9606(lncRNA),URS0002208D5B_9606(lncRNA),URS0002208EDF_9606(lncRNA),URS0002216F35_9606(lncRNA),URS000221A6A0_9606(lncRNA),URS000223FE99_9606(lncRNA),URS0002260337_9606(lncRNA),URS000226770B_9606(lncRNA),URS00022781C2_9606(lncRNA),URS00022B027D_9606(lncRNA),URS00022B07C8_9606(lncRNA),URS00022B1A2C_9606(lncRNA),URS00022B3FCA_9606(lncRNA),URS00022B4176_9606(lncRNA),URS00022B5375_9606(lncRNA),URS00022B5526_9606(lncRNA),URS00022B5F90_9606(lncRNA),URS00022B6104_9606(lncRNA),URS00022B670C_9606(lncRNA),URS00022B6AB7_9606(lncRNA),URS00022B6F27_9606(lncRNA),URS00022B7451_9606(lncRNA),URS00022B760E_9606(lncRNA),URS00022B8D89_9606(lncRNA)	A	SM-ONLY
chr6	85677582	85677658	-	26	26	0	SNHG5(lncRNA),SNORD50B(snoRNA),URS00005A07F1_9606(piRNA),URS00006F8A66_9606(snoRNA),URS000075B42D_9606(lncRNA),URS000075DF75_9606(snoRNA),URS00008C0996_9606(lncRNA),URS00008C10C0_9606(lncRNA),URS00008C1525_9606(lncRNA),URS00008C17FC_9606(lncRNA),URS00008C1E78_9606(lncRNA),URS00008C2D93_9606(lncRNA),URS00008C2F18_9606(lncRNA),URS00008C390C_9606(lncRNA),URS00008C3D3F_9606(lncRNA),URS00009AD3AE_9606(lncRNA),URS00009AD95F_9606(lncRNA),URS00009AFEAD_9606(lncRNA),URS00009B0872_9606(lncRNA),URS00009B2777_9606(lncRNA),URS00009B6A3B_9606(lncRNA),URS00009B6DEE_9606(lncRNA),URS00009B7C98_9606(lncRNA),URS00009B815E_9606(lncRNA),URS00009B850F_9606(lncRNA),URS00009B8CAA_9606(lncRNA),URS00009BA38D_9606(lncRNA),URS00009C0048_9606(lncRNA),URS00009C1433_9606(lncRNA),URS00009C2139_9606(lncRNA),URS00009C3297_9606(lncRNA),URS00009C3819_9606(lncRNA),URS0000A7981B_9606(lncRNA),URS0000AB0B09_9606(lncRNA),URS0000D575C4_9606(lncRNA),URS0000D57E2C_9606(lncRNA),URS0000D5834F_9606(lncRNA),URS0000D5837F_9606(lncRNA),URS0000D58450_9606(lncRNA),URS0000D584F8_9606(lncRNA),URS0000D59050_9606(lncRNA),URS0000D59687_9606(lncRNA),URS0000D59CD4_9606(lncRNA),URS0000D59E4C_9606(lncRNA),URS0000D5A9ED_9606(lncRNA),URS0000D5AC4A_9606(lncRNA),URS0000D5B094_9606(lncRNA),URS0000D5BC42_9606(lncRNA),URS0000D5BE8E_9606(lncRNA),URS0000D5C0B4_9606(lncRNA),URS0000D5D6A9_9606(lncRNA),URS0000D5D7D6_9606(lncRNA),URS0000D5DA2B_9606(lncRNA),URS0000D5DB14_9606(lncRNA),URS0000D5E0D2_9606(lncRNA),URS0000DBA17D_9606(lncRNA),URS0000EA21A5_9606(lncRNA),URS0000EEB4B8_9606(lncRNA),URS0000EEB61A_9606(lncRNA),URS0000EEB94D_9606(lncRNA),URS0000EEBA21_9606(lncRNA),URS0000EEC256_9606(lncRNA),URS0000EEC34C_9606(lncRNA),URS0000EEC9D1_9606(lncRNA),URS0000EECBCA_9606(lncRNA),URS0000EED3D3_9606(lncRNA),URS0000EED8C4_9606(lncRNA),URS0000EEDC2D_9606(lncRNA),URS0000EEE093_9606(lncRNA),URS0000EEE2E9_9606(lncRNA),URS0000EEE462_9606(lncRNA),URS0000EEE586_9606(lncRNA),URS0000EEEEC0_9606(lncRNA),URS0000EEF176_9606(lncRNA),URS0000EEF3B3_9606(lncRNA),URS0000EEF4D1_9606(lncRNA),URS0000EEF5B1_9606(lncRNA),URS0000EEF5E0_9606(lncRNA),URS0000EEF712_9606(lncRNA),URS0000EEFA14_9606(lncRNA),URS0000EEFA95_9606(lncRNA),URS0000EEFE28_9606(lncRNA),URS0000EEFE66_9606(lncRNA),URS0000EEFF0C_9606(lncRNA),URS0000EF027D_9606(lncRNA),URS0000EF0557_9606(lncRNA),URS0000EF0C79_9606(lncRNA),URS0000EF110D_9606(lncRNA),URS0000EF16A6_9606(lncRNA),URS0000EF194C_9606(lncRNA),URS0000EF1CF6_9606(lncRNA),URS0000EF1D15_9606(lncRNA),URS0000EF1D5D_9606(lncRNA),URS0000EF2495_9606(lncRNA),URS0000EF26A6_9606(lncRNA),URS0000EF26C6_9606(lncRNA),URS0000EF2E4C_9606(lncRNA),URS0000EF2E95_9606(lncRNA),URS0000EF2F6C_9606(lncRNA),URS0000EF33EA_9606(lncRNA),URS0000EF3A07_9606(lncRNA),URS0000EF3DF1_9606(lncRNA),URS0000EF3FEE_9606(lncRNA),URS0000EF4099_9606(lncRNA),URS0000EF4246_9606(lncRNA),URS0000EF438B_9606(lncRNA),URS0000EF4456_9606(lncRNA),URS0000EF4488_9606(lncRNA),URS0000EF44C6_9606(lncRNA),URS0000EF45AF_9606(lncRNA),URS0000EF461D_9606(lncRNA),URS0000EF4BFD_9606(lncRNA),URS0000EF4C00_9606(lncRNA),URS0000EF4E23_9606(lncRNA),URS0000EF5343_9606(lncRNA),URS0000EF540C_9606(lncRNA),URS0000EF5AF3_9606(lncRNA),URS0000EF5E15_9606(lncRNA),URS0000EF5EA9_9606(lncRNA),URS0000EF5EF1_9606(lncRNA),URS0000EF62FB_9606(lncRNA),URS0000EF6361_9606(lncRNA),URS0000EF6384_9606(lncRNA),URS0000EF6C9B_9606(lncRNA),URS0000EF6CCC_9606(lncRNA),URS0000EF6DD6_9606(lncRNA),URS0000EF6F51_9606(lncRNA),URS0000EF6FD7_9606(lncRNA),URS0000EF72DF_9606(lncRNA),URS0001987091_9606(lncRNA),URS0001989D0F_9606(lncRNA),URS000198B785_9606(lncRNA),URS000198CF16_9606(lncRNA),URS0001999DC8_9606(lncRNA),URS0001BC6297_9606(snoRNA),URS0001BD3B35_9606(lncRNA),URS0001BD681C_9606(lncRNA),URS0001BDD2C1_9606(lncRNA),URS0001BE0085_9606(lncRNA),URS0001BEBFDC_9606(lncRNA),URS0001BECFC0_9606(lncRNA),URS0001BF1182_9606(lncRNA),URS0001BF39F2_9606(lncRNA),URS0001BF8677_9606(lncRNA),URS000221FC42_9606(lncRNA),URS0002222E03_9606(lncRNA),URS000225D6F6_9606(lncRNA)	A	SM-ONLY
chr11	62854617	62854695	-	26	26	0	SNHG1(lncRNA),SNORD28(snoRNA),URS000015A7CF_9606(snoRNA),URS00005F4016_9606(misc_RNA),URS00008C0C32_9606(lncRNA),URS00008C0CC6_9606(lncRNA),URS00008C1085_9606(lncRNA),URS00008C12CA_9606(lncRNA),URS00008C1464_9606(lncRNA),URS00008C1508_9606(lncRNA),URS00008C167B_9606(lncRNA),URS00008C191F_9606(lncRNA),URS00008C1A56_9606(lncRNA),URS00008C1CD0_9606(lncRNA),URS00008C1D08_9606(lncRNA),URS00008C2147_9606(lncRNA),URS00008C22A8_9606(lncRNA),URS00008C22F5_9606(lncRNA),URS00008C2432_9606(lncRNA),URS00008C24BC_9606(lncRNA),URS00008C2EDC_9606(lncRNA),URS00008C355C_9606(lncRNA),URS00008C392D_9606(lncRNA),URS00008C3AA7_9606(lncRNA),URS00008C3E49_9606(lncRNA),URS00008C409D_9606(lncRNA),URS00009B63CD_9606(lncRNA),URS00009B9E39_9606(lncRNA),URS00009BAB70_9606(lncRNA),URS00009BB13E_9606(lncRNA),URS00009BC8FE_9606(lncRNA),URS00009BEBF4_9606(lncRNA),URS00009BF63C_9606(lncRNA),URS0000CCDF81_9606(lncRNA),URS0000CCDFCF_9606(lncRNA),URS0000CCDFDF_9606(lncRNA),URS0000CCE06F_9606(lncRNA),URS0000CCE076_9606(lncRNA),URS0000CCE0AB_9606(lncRNA),URS0000CCE0B4_9606(lncRNA),URS0000CCE0BC_9606(lncRNA),URS0000CCE0E1_9606(lncRNA),URS0000CCE108_9606(lncRNA),URS0000CCE128_9606(lncRNA),URS0000CCE14E_9606(lncRNA),URS0000D57192_9606(lncRNA),URS0000D5722B_9606(lncRNA),URS0000D577F5_9606(lncRNA),URS0000D57F9D_9606(lncRNA),URS0000D583DF_9606(lncRNA),URS0000D5874A_9606(lncRNA),URS0000D58A95_9606(lncRNA),URS0000D58D79_9606(lncRNA),URS0000D58E2D_9606(lncRNA),URS0000D58F0C_9606(lncRNA),URS0000D58F7B_9606(lncRNA),URS0000D5976C_9606(lncRNA),URS0000D5A047_9606(lncRNA),URS0000D5A3CA_9606(lncRNA),URS0000D5A664_9606(lncRNA),URS0000D5A7A2_9606(lncRNA),URS0000D5ACC0_9606(lncRNA),URS0000D5AE9B_9606(lncRNA),URS0000D5B306_9606(lncRNA),URS0000D5B526_9606(lncRNA),URS0000D5B874_9606(lncRNA),URS0000D5C0E1_9606(lncRNA),URS0000D5C4AC_9606(lncRNA),URS0000D5C936_9606(lncRNA),URS0000D5C999_9606(lncRNA),URS0000D5CA9E_9606(lncRNA),URS0000D5CE46_9606(lncRNA),URS0000D5D344_9606(lncRNA),URS0000D5D697_9606(lncRNA),URS0000D5DB22_9606(lncRNA),URS0000D5DF6D_9606(lncRNA),URS0000D5E3D8_9606(lncRNA),URS0000EEAEF8_9606(lncRNA),URS0000EEB6FE_9606(lncRNA),URS0000EEC386_9606(lncRNA),URS0000EEC677_9606(lncRNA),URS0000EEC7F2_9606(lncRNA),URS0000EECE76_9606(lncRNA),URS0000EEE090_9606(lncRNA),URS0000EEEED6_9606(lncRNA),URS0000EEF08F_9606(lncRNA),URS0000EEF2B0_9606(lncRNA),URS0000EEFB92_9606(lncRNA),URS0000EEFF3B_9606(lncRNA),URS0000EEFF46_9606(lncRNA),URS0000EF0DB0_9606(lncRNA),URS0000EF120E_9606(lncRNA),URS0000EF123A_9606(lncRNA),URS0000EF1858_9606(lncRNA),URS0000EF21B0_9606(lncRNA),URS0000EF2DFF_9606(lncRNA),URS0000EF301C_9606(lncRNA),URS0000EF3572_9606(lncRNA),URS0000EF37E8_9606(lncRNA),URS0000EF3A9F_9606(lncRNA),URS0000EF3CF1_9606(lncRNA),URS0000EF3DF9_9606(lncRNA),URS0000EF3F1E_9606(lncRNA),URS0000EF4F8E_9606(lncRNA),URS0000EF5E17_9606(lncRNA),URS0000EF6AE6_9606(lncRNA),URS0000EF6DD5_9606(lncRNA),URS00019EB4E2_9606(lncRNA),URS0001BC498B_9606(snoRNA),URS0001BCAB26_9606(lncRNA),URS0001BCB0B6_9606(lncRNA),URS0001BCCC88_9606(lncRNA),URS0001BCD596_9606(lncRNA),URS0001BD06A8_9606(lncRNA),URS0001BD52E5_9606(lncRNA),URS0001BD6BA6_9606(lncRNA),URS0001BD6FE6_9606(snoRNA),URS0001BD846E_9606(lncRNA),URS0001BD9C2E_9606(lncRNA),URS0001BDD58E_9606(lncRNA),URS0001BDF7F4_9606(lncRNA),URS0001BDFE60_9606(lncRNA),URS0001BE1ECE_9606(lncRNA),URS0001BE2C73_9606(lncRNA),URS0001BE5B4C_9606(lncRNA),URS0001BE719F_9606(lncRNA),URS0001BE7311_9606(lncRNA),URS0001BE75DE_9606(lncRNA),URS0001BE9A8D_9606(lncRNA),URS0001BEA6C7_9606(lncRNA),URS0001BEE0F5_9606(lncRNA),URS0001BEFAFF_9606(lncRNA),URS0001BF0F3B_9606(lncRNA),URS0001BF2ABE_9606(lncRNA),URS0001BF32E6_9606(lncRNA),URS0001BF7152_9606(lncRNA),URS0001BF78F6_9606(lncRNA),URS0001BF8051_9606(lncRNA),URS0001BF8847_9606(lncRNA),URS0001BF88A5_9606(lncRNA),URS0001BF918D_9606(lncRNA),URS0001BF9715_9606(lncRNA),URS0001BF9F44_9606(lncRNA),URS0001C778E7_9606(lncRNA),URS0001E80857_9606(lncRNA),URS000224B7D5_9606(lncRNA),URS0002262841_9606(lncRNA),URS000226E769_9606(lncRNA),URS00022AF335_9606(lncRNA),URS00022AF3D3_9606(lncRNA),URS00022AF716_9606(lncRNA),URS00022AF98F_9606(lncRNA),URS00022AFC46_9606(lncRNA),URS00022B0198_9606(lncRNA),URS00022B0581_9606(lncRNA),URS00022B0956_9606(lncRNA),URS00022B0C17_9606(lncRNA),URS00022B14A8_9606(lncRNA),URS00022B2175_9606(lncRNA),URS00022B3507_9606(lncRNA),URS00022B437F_9606(lncRNA),URS00022B6E99_9606(lncRNA),URS00022B7711_9606(lncRNA),URS00022B781F_9606(lncRNA),URS00022B7FCB_9606(lncRNA),URS00022B81C8_9606(lncRNA),URS00022B81D1_9606(lncRNA),URS00022B82C5_9606(lncRNA),URS00022B87F3_9606(lncRNA),URS00022B87F5_9606(lncRNA),URS00022B8E00_9606(lncRNA)	A	SM-ONLY
chr15	66502859	66502911	-	22	22	0	RPL4(protein_coding),SNORD16(snoRNA),URS0000535D45_9606(snoRNA),URS0000679E95_9606(snoRNA),URS000082CD7E_9606(snoRNA),URS00008BD0E5_9606(lncRNA),URS0000D6E75E_9606(lncRNA),URS0001BC566A_9606(snoRNA)	A	SM-PC
chr17	28723683	28723753	+	16	16	0	RPL23A(protein_coding),SNORD4B(snoRNA),URS0000456F03_9606(snoRNA),URS0000692106_9606(snoRNA),URS0001BBF447_9606(snoRNA),URS0001BED105_9606(lncRNA)	A	SM-PC
chr11	93733546	93733598	-	14	14	0	SNORA18(snoRNA),TAF1D(protein_coding),URS0000202A89_9606(snoRNA),URS00008B44CA_9606(lncRNA),URS00008B52AF_9606(lncRNA),URS00008B875B_9606(lncRNA),URS00008BB796_9606(lncRNA),URS00008BBE72_9606(lncRNA),URS00008BEBE5_9606(lncRNA),URS00008BF46D_9606(lncRNA),URS00008C015E_9606(lncRNA),URS0000D6D7CF_9606(lncRNA),URS0001BBEEC2_9606(snoRNA)	A	SM-PC
chr1	173866304	173866367	-	8	8	0	GAS5(lncRNA),URS00005E7AC7_9606(snoRNA),URS0000646D2B_9606(snoRNA),URS000072F791_9606(snoRNA),URS000082A21B_9606(snoRNA),URS00008B3431_9606(lncRNA),URS00008B3C85_9606(lncRNA),URS00008B4DAD_9606(lncRNA),URS00008B6DB9_9606(lncRNA),URS00008B7CE9_9606(lncRNA),URS00008B883D_9606(lncRNA),URS00008BB2ED_9606(lncRNA),URS00008BC666_9606(lncRNA),URS00008BD472_9606(lncRNA),URS00008C0058_9606(lncRNA),URS00008C090E_9606(lncRNA),URS00008C0A79_9606(lncRNA),URS00008C0C72_9606(lncRNA),URS00008C0D76_9606(lncRNA),URS00008C15F6_9606(lncRNA),URS00008C19D0_9606(lncRNA),URS00008C1BCE_9606(lncRNA),URS00008C2157_9606(lncRNA),URS00008C24EE_9606(lncRNA),URS00008C2BF5_9606(lncRNA),URS00008C2E96_9606(lncRNA),URS00008C371B_9606(lncRNA),URS00008C3A01_9606(lncRNA),URS00008C4009_9606(lncRNA),URS00009AE80F_9606(lncRNA),URS00009AEE8E_9606(lncRNA),URS00009B629F_9606(lncRNA),URS00009BA636_9606(lncRNA),URS00009BBB44_9606(lncRNA),URS00009BCE1D_9606(lncRNA),URS00009C227F_9606(lncRNA),URS00009C4337_9606(lncRNA),URS00009C4AE5_9606(lncRNA),URS0000A80260_9606(lncRNA),URS0000AB0ACF_9606(lncRNA),URS0000CCDF7F_9606(lncRNA),URS0000CCDFCD_9606(lncRNA),URS0000CCDFEE_9606(lncRNA),URS0000CCE004_9606(lncRNA),URS0000CCE03F_9606(lncRNA),URS0000CCE053_9606(lncRNA),URS0000CCE07A_9606(lncRNA),URS0000CCE0B6_9606(lncRNA),URS0000CCE0C1_9606(lncRNA),URS0000CCE0C7_9606(lncRNA),URS0000CCE0E6_9606(lncRNA),URS0000CCE0FF_9606(lncRNA),URS0000CCE104_9606(lncRNA),URS0000CCE10E_9606(lncRNA),URS0000CCE12A_9606(lncRNA),URS0000D56DBC_9606(lncRNA),URS0000D5711B_9606(lncRNA),URS0000D574C4_9606(lncRNA),URS0000D57AAB_9606(lncRNA),URS0000D57C33_9606(lncRNA),URS0000D57C9D_9606(lncRNA),URS0000D580E5_9606(lncRNA),URS0000D58B68_9606(lncRNA),URS0000D58CB2_9606(lncRNA),URS0000D58D56_9606(lncRNA),URS0000D58E93_9606(lncRNA),URS0000D5948E_9606(lncRNA),URS0000D5951F_9606(lncRNA),URS0000D59535_9606(lncRNA),URS0000D5A48C_9606(lncRNA),URS0000D5A608_9606(lncRNA),URS0000D5A76D_9606(lncRNA),URS0000D5AA2B_9606(lncRNA),URS0000D5AB45_9606(lncRNA),URS0000D5B449_9606(lncRNA),URS0000D5B48A_9606(lncRNA),URS0000D5C1C4_9606(lncRNA),URS0000D5C34A_9606(lncRNA),URS0000D5C393_9606(lncRNA),URS0000D5C3C1_9606(lncRNA),URS0000D5C5C1_9606(lncRNA),URS0000D5C60C_9606(lncRNA),URS0000D5C735_9606(lncRNA),URS0000D5C88D_9606(lncRNA),URS0000D5CD7C_9606(lncRNA),URS0000D5CE9A_9606(lncRNA),URS0000D5D155_9606(lncRNA),URS0000D5D3F7_9606(lncRNA),URS0000D5D74F_9606(lncRNA),URS0000D5DB9C_9606(lncRNA),URS0000EA0F94_9606(lncRNA),URS0000EF4377_9606(lncRNA),URS00019BF8D5_9606(lncRNA),URS0001BC53F7_9606(snoRNA),URS0001BCCF8B_9606(lncRNA),URS0001BCD56D_9606(lncRNA),URS0001BCD741_9606(lncRNA),URS0001BCDE3D_9606(lncRNA),URS0001BCE45E_9606(lncRNA),URS0001BCF2DD_9606(lncRNA),URS0001BD044C_9606(lncRNA),URS0001BD1A51_9606(lncRNA),URS0001BD3771_9606(lncRNA),URS0001BD3FEF_9606(lncRNA),URS0001BD4316_9606(lncRNA),URS0001BD50F2_9606(lncRNA),URS0001BD549F_9606(lncRNA),URS0001BD6878_9606(lncRNA),URS0001BD6EFB_9606(lncRNA),URS0001BD742C_9606(lncRNA),URS0001BD8757_9606(lncRNA),URS0001BDAB6D_9606(lncRNA),URS0001BDBD5F_9606(lncRNA),URS0001BDC64F_9606(lncRNA),URS0001BE02C6_9606(lncRNA),URS0001BE0468_9606(lncRNA),URS0001BE169A_9606(lncRNA),URS0001BE1BF4_9606(lncRNA),URS0001BE1F67_9606(lncRNA),URS0001BE2106_9606(lncRNA),URS0001BE22CC_9606(lncRNA),URS0001BE30C4_9606(lncRNA),URS0001BE4E6D_9606(lncRNA),URS0001BE55B9_9606(lncRNA),URS0001BE6D3C_9606(lncRNA),URS0001BE73B4_9606(lncRNA),URS0001BE9684_9606(lncRNA),URS0001BEA36A_9606(lncRNA),URS0001BEA4A7_9606(lncRNA),URS0001BEAF6D_9606(lncRNA),URS0001BEB416_9606(lncRNA),URS0001BEFBA2_9606(lncRNA),URS0001BEFBA8_9606(lncRNA),URS0001BEFF33_9606(lncRNA),URS0001BF0144_9606(lncRNA),URS0001BF03AF_9606(lncRNA),URS0001BF107B_9606(lncRNA),URS0001BF2483_9606(lncRNA),URS0001BF28F7_9606(lncRNA),URS0001BF5440_9606(lncRNA),URS0001BF738C_9606(lncRNA),URS0001BF8218_9606(lncRNA),URS0001BF8EC8_9606(lncRNA),URS0001BF9C77_9606(lncRNA),URS0001BF9F5D_9606(lncRNA),URS0001BFA1B0_9606(lncRNA),URS0001BFA68C_9606(lncRNA),URS00021FBAD5_9606(lncRNA),URS0002218A4A_9606(lncRNA),URS0002276C2D_9606(lncRNA),URS00022AE845_9606(lncRNA),URS00022AEE19_9606(lncRNA),URS00022AEEFE_9606(lncRNA),URS00022AF133_9606(lncRNA),URS00022B0225_9606(lncRNA),URS00022B0C15_9606(lncRNA),URS00022B137A_9606(lncRNA),URS00022B15AA_9606(lncRNA),URS00022B1858_9606(lncRNA),URS00022B1EF5_9606(lncRNA),URS00022B2095_9606(lncRNA),URS00022B21B2_9606(lncRNA),URS00022B2236_9606(lncRNA),URS00022B23C3_9606(lncRNA),URS00022B2A25_9606(lncRNA),URS00022B30ED_9606(lncRNA),URS00022B3120_9606(lncRNA),URS00022B3949_9606(lncRNA),URS00022B3A51_9606(lncRNA),URS00022B3D16_9606(lncRNA),URS00022B3D8A_9606(lncRNA),URS00022B3E09_9606(lncRNA),URS00022B3EF9_9606(lncRNA),URS00022B3FAD_9606(lncRNA),URS00022B45C4_9606(lncRNA),URS00022B461B_9606(lncRNA),URS00022B4821_9606(lncRNA),URS00022B4B51_9606(lncRNA),URS00022B575C_9606(lncRNA),URS00022B591C_9606(lncRNA),URS00022B5B49_9606(lncRNA),URS00022B5EC0_9606(lncRNA),URS00022B671C_9606(lncRNA),URS00022B74A0_9606(lncRNA),URS00022B7566_9606(lncRNA),URS00022B77FD_9606(lncRNA),URS00022B7A55_9606(lncRNA),URS00022B8675_9606(lncRNA),URS00022B8D24_9606(lncRNA),URS00022B8E31_9606(lncRNA),URS00022B8E3A_9606(lncRNA),URS00022B8FB5_9606(lncRNA),URS00022B8FC7_9606(lncRNA),URS00022B9426_9606(lncRNA),URS00022B9481_9606(lncRNA),URS00022B962E_9606(lncRNA)	A	SM-ONLY
chr16	70778218	70778278	-	7	7	0	URS000009AC8B_9606(tRNA),URS00000D5F4F_9606(piRNA),URS000016F8FA_9606(piRNA),URS00001A10BC_9606(piRNA),URS00002F3702_9606(piRNA),URS0000303544_9606(piRNA),URS000039F481_9606(piRNA),URS00003D4D35_9606(piRNA),URS0000402504_9606(piRNA),URS00004B4C1C_9606(piRNA),URS00004DCC2C_9606(piRNA),URS0000CAFDAA_9606(miRNA)	A	SM-ONLY
chr17	8119195	8119246	+	7	7	0	URS00000AEA65_9606(piRNA),URS00000B5411_9606(piRNA),URS00000C5271_9606(piRNA),URS0000175969_9606(piRNA),URS0000198859_9606(piRNA),URS00001A3F56_9606(piRNA),URS00002222F7_9606(tRNA),URS000022DD4A_9606(tRNA),URS00002311F9_9606(piRNA),URS0000232F06_9606(piRNA),URS00002CE51F_9606(piRNA),URS00002F1C99_9606(piRNA),URS000032F6AC_9606(tRNA),URS0000388228_9606(piRNA),URS0000396EF6_9606(piRNA),URS0000485112_9606(piRNA),URS00004EB9FC_9606(piRNA),URS000059B34B_9606(piRNA),URS00005CC0FA_9606(piRNA),URS00008FED2A_9606(tRNA),URS0000D54ECB_9606(tRNA),URS0001BC81BD_9606(tRNA)	A	SM-ONLY
chr11	93733460	93733515	-	6	6	0	SNORA18(snoRNA),TAF1D(protein_coding),URS0000202A89_9606(snoRNA),URS00008B44CA_9606(lncRNA),URS00008B52AF_9606(lncRNA),URS00008B875B_9606(lncRNA),URS00008BB796_9606(lncRNA),URS00008BBE72_9606(lncRNA),URS00008BEBE5_9606(lncRNA),URS00008BF46D_9606(lncRNA),URS00008C015E_9606(lncRNA),URS0000D6D7CF_9606(lncRNA),URS0001BBEEC2_9606(snoRNA)	A	SM-PC
